《易乾=《易乾
不著痕跡=不着痕迹
不著邊際=不着边际
與著=与着
與著書=与著书
與著作=与著作
與著名=与著名
與著錄=与著录
與著稱=与著称
與著者=与著者
與著述=与著述
丑著=丑着
丑著书=丑著书
丑著書=丑著书
丑著作=丑著作
丑著名=丑著名
丑著录=丑著录
丑著錄=丑著录
丑著稱=丑著称
丑著称=丑著称
丑著者=丑著者
丑著述=丑著述
專著=专著
臨著=临着
臨著書=临著书
臨著作=临著作
臨著名=临著名
臨著錄=临著录
臨著稱=临著称
臨著者=临著者
臨著述=临著述
麗著=丽着
麗著書=丽著书
麗著作=丽著作
麗著名=丽著名
麗著錄=丽著录
麗著稱=丽著称
麗著者=丽著者
麗著述=丽著述
樂著=乐着
樂著書=乐著书
樂著作=乐著作
樂著名=乐著名
樂著錄=乐著录
樂著稱=乐著称
樂著者=乐著者
樂著述=乐著述
乘著=乘着
乘著书=乘著书
乘著書=乘著书
乘著作=乘著作
乘著名=乘著名
乘著录=乘著录
乘著錄=乘著录
乘著稱=乘著称
乘著称=乘著称
乘著者=乘著者
乘著述=乘著述
乾一坛=乾一坛
乾一壇=乾一坛
乾一组=乾一组
乾一組=乾一组
乾上乾下=乾上乾下
乾為天=乾为天
乾為陽=乾为阳
乾九=乾九
乾乾=乾乾
乾亨=乾亨
乾儀=乾仪
乾仪=乾仪
乾位=乾位
乾健=乾健
乾健也=乾健也
乾元=乾元
乾光=乾光
乾兴=乾兴
乾興=乾兴
乾冈=乾冈
乾岡=乾冈
乾劉=乾刘
乾刘=乾刘
乾剛=乾刚
乾刚=乾刚
乾務=乾务
乾务=乾务
乾化=乾化
乾卦=乾卦
乾县=乾县
乾縣=乾县
乾台=乾台
乾吉=乾吉
乾啟=乾启
乾启=乾启
乾命=乾命
乾和=乾和
乾嘉=乾嘉
乾圖=乾图
乾图=乾图
乾坤=乾坤
乾城=乾城
乾基=乾基
乾天也=乾天也
乾始=乾始
乾姓=乾姓
乾寧=乾宁
乾宁=乾宁
乾宅=乾宅
乾宇=乾宇
乾安=乾安
乾定=乾定
乾封=乾封
乾居=乾居
乾崗=乾岗
乾岗=乾岗
乾巛=乾巛
乾州=乾州
乾式=乾式
乾錄=乾录
乾录=乾录
乾律=乾律
乾德=乾德
乾心=乾心
乾忠=乾忠
乾文=乾文
乾斷=乾断
乾断=乾断
乾方=乾方
乾施=乾施
乾旦=乾旦
乾明=乾明
乾昧=乾昧
乾晖=乾晖
乾暉=乾晖
乾景=乾景
乾晷=乾晷
乾曜=乾曜
乾构=乾构
乾構=乾构
乾枢=乾枢
乾樞=乾枢
乾栋=乾栋
乾棟=乾栋
乾步=乾步
乾氏=乾氏
乾沓和=乾沓和
乾沓婆=乾沓婆
乾泉=乾泉
乾淳=乾淳
乾清宮=乾清宫
乾清宫=乾清宫
乾渥=乾渥
乾靈=乾灵
乾灵=乾灵
乾男=乾男
乾皋=乾皋
乾盛世=乾盛世
乾矢=乾矢
乾祐=乾祐
乾穹=乾穹
乾竇=乾窦
乾窦=乾窦
乾竺=乾竺
乾篤=乾笃
乾笃=乾笃
乾符=乾符
乾策=乾策
乾精=乾精
乾紅=乾红
乾红=乾红
乾綱=乾纲
乾纲=乾纲
乾纽=乾纽
乾紐=乾纽
乾絡=乾络
乾络=乾络
乾統=乾统
乾统=乾统
乾維=乾维
乾维=乾维
乾羅=乾罗
乾罗=乾罗
乾花=乾花
乾蔭=乾荫
乾荫=乾荫
乾行=乾行
乾衡=乾衡
乾覆=乾覆
乾象=乾象
乾象歷=乾象历
乾象历=乾象历
乾贞=乾贞
乾貞=乾贞
乾貺=乾贶
乾贶=乾贶
乾车=乾车
乾車=乾车
乾軸=乾轴
乾轴=乾轴
乾通=乾通
乾造=乾造
乾道=乾道
乾鑒=乾鉴
乾鉴=乾鉴
乾钧=乾钧
乾鈞=乾钧
乾闼=乾闼
乾闥=乾闼
乾陀=乾陀
乾陵=乾陵
乾隆=乾隆
乾音=乾音
乾顾=乾顾
乾顧=乾顾
乾风=乾风
乾風=乾风
乾首=乾首
乾馬=乾马
乾马=乾马
乾鵠=乾鹄
乾鹄=乾鹄
乾鵲=乾鹊
乾鹊=乾鹊
乾龍=乾龙
乾龙=乾龙
乾，健也=乾，健也
乾，天也=乾，天也
爭著=争着
爭著書=争著书
爭著作=争著作
爭著名=争著名
爭著錄=争著录
爭著稱=争著称
爭著者=争著者
爭著述=争著述
五箇山=五箇山
亮著=亮着
亮著书=亮著书
亮著書=亮著书
亮著作=亮著作
亮著名=亮著名
亮著錄=亮著录
亮著录=亮著录
亮著称=亮著称
亮著稱=亮著称
亮著者=亮著者
亮著述=亮著述
仗著=仗着
仗著书=仗著书
仗著書=仗著书
仗著作=仗著作
仗著名=仗著名
仗著录=仗著录
仗著錄=仗著录
仗著稱=仗著称
仗著称=仗著称
仗著者=仗著者
仗著述=仗著述
代表著=代表着
代表著書=代表著书
代表著书=代表著书
代表著作=代表著作
代表著名=代表著名
代表著錄=代表著录
代表著录=代表著录
代表著称=代表著称
代表著稱=代表著称
代表著者=代表著者
代表著述=代表著述
以微知著=以微知著
仰屋著書=仰屋著书
彷彿=仿佛
夥計=伙计
傳著=传着
傳著書=传著书
傳著作=传著作
傳著名=传著名
傳著錄=传著录
傳著稱=传著称
傳著者=传著者
傳著述=传著述
伴著=伴着
伴著书=伴著书
伴著書=伴著书
伴著作=伴著作
伴著名=伴著名
伴著录=伴著录
伴著錄=伴著录
伴著稱=伴著称
伴著称=伴著称
伴著者=伴著者
伴著述=伴著述
低著=低着
低著書=低著书
低著书=低著书
低著作=低著作
低著名=低著名
低著录=低著录
低著錄=低著录
低著稱=低著称
低著称=低著称
低著者=低著者
低著述=低著述
住著=住着
住著書=住著书
住著书=住著书
住著作=住著作
住著名=住著名
住著錄=住著录
住著录=住著录
住著称=住著称
住著稱=住著称
住著者=住著者
住著述=住著述
佛頭著糞=佛头著粪
侏儸紀=侏罗纪
側著=侧着
側著書=侧著书
側著作=侧著作
側著名=侧著名
側著錄=侧著录
側著稱=侧著称
側著者=侧著者
側著述=侧著述
保護著=保护着
保障著=保障着
保障著书=保障著书
保障著書=保障著书
保障著作=保障著作
保障著名=保障著名
保障著錄=保障著录
保障著录=保障著录
保障著稱=保障著称
保障著称=保障著称
保障著者=保障著者
保障著述=保障著述
信著=信着
信著书=信著书
信著書=信著书
信著作=信著作
信著名=信著名
信著录=信著录
信著錄=信著录
信著称=信著称
信著稱=信著称
信著者=信著者
信著述=信著述
修鍊=修炼
候覆=候复
候著=候着
候著書=候著书
候著书=候著书
候著作=候著作
候著名=候著名
候著录=候著录
候著錄=候著录
候著稱=候著称
候著称=候著称
候著者=候著者
候著述=候著述
藉助=借助
藉口=借口
藉手=借手
藉故=借故
藉機=借机
藉此=借此
藉由=借由
借著=借着
藉着=借着
藉著=借着
藉端=借端
借著書=借著书
借著书=借著书
借著作=借著作
借著名=借著名
借著录=借著录
借著錄=借著录
借著称=借著称
借著稱=借著称
借著者=借著者
借著述=借著述
藉詞=借词
做著=做着
做著書=做著书
做著书=做著书
做著作=做著作
做著名=做著名
做著錄=做著录
做著录=做著录
做著稱=做著称
做著称=做著称
做著者=做著者
做著述=做著述
偷著=偷着
偷著書=偷著书
偷著书=偷著书
偷著作=偷著作
偷著名=偷著名
偷著錄=偷著录
偷著录=偷著录
偷著稱=偷著称
偷著称=偷著称
偷著者=偷著者
偷著述=偷著述
傢俬=傢俬
僧伽吒=僧伽吒
光著=光着
光著書=光著书
光著书=光著书
光著作=光著作
光著名=光著名
光著錄=光著录
光著录=光著录
光著稱=光著称
光著称=光著称
光著者=光著者
光著述=光著述
關著=关着
關著書=关著书
關著作=关著作
關著名=关著名
關著錄=关著录
關著稱=关著称
關著者=关著者
關著述=关著述
冀著=冀着
冀著書=冀著书
冀著书=冀著书
冀著作=冀著作
冀著名=冀著名
冀著錄=冀著录
冀著录=冀著录
冀著稱=冀著称
冀著称=冀著称
冀著者=冀著者
冀著述=冀著述
冒著=冒着
冒著书=冒著书
冒著書=冒著书
冒著作=冒著作
冒著名=冒著名
冒著录=冒著录
冒著錄=冒著录
冒著稱=冒著称
冒著称=冒著称
冒著者=冒著者
冒著述=冒著述
寫著=写着
寫著書=写著书
寫著作=写著作
寫著名=写著名
寫著錄=写著录
寫著稱=写著称
寫著者=写著者
寫著述=写著述
涼著=凉着
涼著書=凉著书
涼著作=凉著作
涼著名=凉著名
涼著錄=凉著录
涼著稱=凉著称
涼著者=凉著者
涼著述=凉著述
憑藉=凭借
制著=制着
制著书=制著书
制著書=制著书
制著作=制著作
制著名=制著名
制著錄=制著录
制著录=制著录
制著称=制著称
制著稱=制著称
制著者=制著者
制著述=制著述
刻著=刻着
刻著書=刻著书
刻著书=刻著书
刻著作=刻著作
刻著名=刻著名
刻著录=刻著录
刻著錄=刻著录
刻著稱=刻著称
刻著称=刻著称
刻著者=刻著者
刻著述=刻著述
辦著=办着
辦著書=办著书
辦著作=办著作
辦著名=办著名
辦著錄=办著录
辦著稱=办著称
辦著者=办著者
辦著述=办著述
動著=动着
動著書=动著书
動著作=动著作
動著名=动著名
動著錄=动著录
動著稱=动著称
動著者=动著者
動著述=动著述
努力著=努力着
努力著書=努力著书
努力著书=努力著书
努力著作=努力著作
努力著名=努力著名
努力著錄=努力著录
努力著录=努力著录
努力著称=努力著称
努力著稱=努力著称
努力著者=努力著者
努力著述=努力著述
努著=努着
努著書=努著书
努著书=努著书
努著作=努著作
努著名=努著名
努著錄=努著录
努著录=努著录
努著称=努著称
努著稱=努著称
努著者=努著者
努著述=努著述
卓著=卓著
印著=印着
印著书=印著书
印著書=印著书
印著作=印著作
印著名=印著名
印著录=印著录
印著錄=印著录
印著称=印著称
印著稱=印著称
印著者=印著者
印著述=印著述
卷舌=卷舌
壓著=压着
壓著書=压著书
壓著作=压著作
壓著名=压著名
壓著錄=压著录
壓著稱=压著称
壓著者=压著者
壓著述=压著述
原著=原著
去著=去着
去著书=去著书
去著書=去著书
去著作=去著作
去著名=去著名
去著录=去著录
去著錄=去著录
去著稱=去著称
去著称=去著称
去著者=去著者
去著述=去著述
反反覆覆=反反复复
反覆=反复
受著=受着
受著書=受著书
受著书=受著书
受著作=受著作
受著名=受著名
受著錄=受著录
受著录=受著录
受著稱=受著称
受著称=受著称
受著者=受著者
受著述=受著述
變著=变着
變著書=变著书
變著作=变著作
變著名=变著名
變著錄=变著录
變著稱=变著称
變著者=变著者
變著述=变著述
叫著=叫着
叫著书=叫著书
叫著書=叫著书
叫著作=叫著作
叫著名=叫著名
叫著录=叫著录
叫著錄=叫著录
叫著称=叫著称
叫著稱=叫著称
叫著者=叫著者
叫著述=叫著述
可穿著=可穿著
叱吒=叱吒
吃不著=吃不着
吃得著=吃得着
吃著=吃着
吃衣著飯=吃衣著饭
合著=合著
名著=名著
向著=向着
向著書=向著书
向著书=向著书
向著作=向著作
向著名=向著名
向著錄=向著录
向著录=向著录
向著称=向著称
向著稱=向著称
向著者=向著者
向著述=向著述
含著=含着
含著書=含著书
含著书=含著书
含著作=含著作
含著名=含著名
含著錄=含著录
含著录=含著录
含著称=含著称
含著稱=含著称
含著者=含著者
含著述=含著述
聽不著=听不着
聽得著=听得着
聽著=听着
聽著書=听著书
聽著作=听著作
聽著名=听著名
聽著錄=听著录
聽著稱=听著称
聽著者=听著者
聽著述=听著述
吴其濬=吴其濬
吳其濬=吴其濬
吹著=吹着
吹著書=吹著书
吹著书=吹著书
吹著作=吹著作
吹著名=吹著名
吹著录=吹著录
吹著錄=吹著录
吹著稱=吹著称
吹著称=吹著称
吹著者=吹著者
吹著述=吹著述
周易乾=周易乾
味著=味着
味著书=味著书
味著書=味著书
味著作=味著作
味著名=味著名
味著录=味著录
味著錄=味著录
味著称=味著称
味著稱=味著称
味著者=味著者
味著述=味著述
呼幺喝六=呼幺喝六
響著=响着
響著書=响著书
響著作=响著作
響著名=响著名
響著錄=响著录
響著稱=响著称
響著者=响著者
響著述=响著述
哪吒=哪吒
哭著=哭着
哭著書=哭著书
哭著书=哭著书
哭著作=哭著作
哭著名=哭著名
哭著錄=哭著录
哭著录=哭著录
哭著稱=哭著称
哭著称=哭著称
哭著者=哭著者
哭著述=哭著述
唱著=唱着
唱著书=唱著书
唱著書=唱著书
唱著作=唱著作
唱著名=唱著名
唱著录=唱著录
唱著錄=唱著录
唱著称=唱著称
唱著稱=唱著称
唱著者=唱著者
唱著述=唱著述
喝著=喝着
喝著书=喝著书
喝著書=喝著书
喝著作=喝著作
喝著名=喝著名
喝著录=喝著录
喝著錄=喝著录
喝著稱=喝著称
喝著称=喝著称
喝著者=喝著者
喝著述=喝著述
嗅不著=嗅不着
嗅得著=嗅得着
嗅著=嗅着
嚷著=嚷着
嚷著書=嚷著书
嚷著书=嚷著书
嚷著作=嚷著作
嚷著名=嚷著名
嚷著錄=嚷著录
嚷著录=嚷著录
嚷著称=嚷著称
嚷著稱=嚷著称
嚷著者=嚷著者
嚷著述=嚷著述
回覆=回复
因著=因着
因著〈=因著〈
因著《=因著《
因著書=因著书
因著书=因著书
因著作=因著作
因著名=因著名
因著錄=因著录
因著录=因著录
因著稱=因著称
因著称=因著称
因著者=因著者
因著述=因著述
困著=困着
困著書=困著书
困著书=困著书
困著作=困著作
困著名=困著名
困著錄=困著录
困著录=困著录
困著称=困著称
困著稱=困著称
困著者=困著者
困著述=困著述
圍著=围着
圍著書=围著书
圍著作=围著作
圍著名=围著名
圍著錄=围著录
圍著稱=围著称
圍著者=围著者
圍著述=围著述
土著=土著
在著=在着
在著書=在著书
在著书=在著书
在著作=在著作
在著名=在著名
在著錄=在著录
在著录=在著录
在著稱=在著称
在著称=在著称
在著者=在著者
在著述=在著述
坐著=坐着
坐著书=坐著书
坐著書=坐著书
坐著作=坐著作
坐著名=坐著名
坐著录=坐著录
坐著錄=坐著录
坐著称=坐著称
坐著稱=坐著称
坐著者=坐著者
坐著述=坐著述
坤乾=坤乾
備著=备着
備著書=备著书
備著作=备著作
備著名=备著名
備著錄=备著录
備著稱=备著称
備著者=备著者
備著述=备著述
覆查=复查
覆核=复核
天道为乾=天道为乾
天道為乾=天道为乾
太閤=太阁
夾著=夹着
夾著書=夹著书
夾著作=夹著作
夾著名=夹著名
夾著錄=夹著录
夾著稱=夹著称
夾著者=夹著者
夾著述=夹著述
奧區=奧区
姓幺=姓幺
字乾生=字乾生
存摺=存摺
孤著=孤着
孤著书=孤著书
孤著書=孤著书
孤著作=孤著作
孤著名=孤著名
孤著錄=孤著录
孤著录=孤著录
孤著称=孤著称
孤著稱=孤著称
孤著者=孤著者
孤著述=孤著述
學著=学着
學著書=学著书
學著作=学著作
學著名=学著名
學著錄=学著录
學著稱=学著称
學著者=学著者
學著述=学著述
守著=守着
守著書=守著书
守著书=守著书
守著作=守著作
守著名=守著名
守著录=守著录
守著錄=守著录
守著称=守著称
守著稱=守著称
守著者=守著者
守著述=守著述
定著=定着
定著書=定著书
定著书=定著书
定著作=定著作
定著名=定著名
定著錄=定著录
定著录=定著录
定著称=定著称
定著稱=定著称
定著者=定著者
定著述=定著述
對著=对着
對著書=对著书
對著作=对著作
對著名=对著名
對著錄=对著录
對著稱=对著称
對著者=对著者
對著述=对著述
尋著=寻着
尋著書=寻著书
尋著作=寻著作
尋著名=寻著名
尋著錄=寻著录
尋著稱=寻著称
尋著者=寻著者
尋著述=寻著述
將軍抽車=将军抽車
尼乾陀=尼乾陀
展著=展着
展著書=展著书
展著书=展著书
展著作=展著作
展著名=展著名
展著錄=展著录
展著录=展著录
展著稱=展著称
展著称=展著称
展著者=展著者
展著述=展著述
峯岸南=峯岸南
巨著=巨著
帶著=带着
帶著書=带著书
帶著作=带著作
帶著名=带著名
帶著錄=带著录
帶著稱=带著称
帶著者=带著者
帶著述=带著述
幫著=帮着
幫著書=帮著书
幫著作=帮著作
幫著名=帮著名
幫著錄=帮著录
幫著稱=帮著称
幫著者=帮著者
幫著述=帮著述
乾乾淨淨=干干净净
乾乾脆脆=干干脆脆
乾泉水=干泉水
幹著=干着
么二三=幺二三
幺二三=幺二三
么元=幺元
幺元=幺元
幺鳳=幺凤
么鳳=幺凤
么半群=幺半群
幺半群=幺半群
幺廝=幺厮
幺厮=幺厮
幺叔=幺叔
么叔=幺叔
么媽=幺妈
幺媽=幺妈
么妹=幺妹
幺妹=幺妹
么姓=幺姓
幺姓=幺姓
么姨=幺姨
幺姨=幺姨
么娘=幺娘
么孃=幺娘
幺娘=幺娘
幺孃=幺娘
幺小=幺小
么小=幺小
幺氏=幺氏
么氏=幺氏
么爸=幺爸
幺爸=幺爸
幺爹=幺爹
么爹=幺爹
么篇=幺篇
幺篇=幺篇
么舅=幺舅
幺舅=幺舅
么蛾子=幺蛾子
幺蛾子=幺蛾子
么謙=幺谦
幺謙=幺谦
幺麽=幺麽
么麼=幺麽
幺麽小丑=幺麽小丑
么麼小丑=幺麽小丑
庇護著=庇护着
應著=应着
應著書=应著书
應著作=应著作
應著名=应著名
應著錄=应著录
應著稱=应著称
應著者=应著者
應著述=应著述
康乾=康乾
康著=康着
康著书=康著书
康著書=康著书
康著作=康著作
康著名=康著名
康著录=康著录
康著錄=康著录
康著称=康著称
康著稱=康著称
康著者=康著者
康著述=康著述
開著=开着
開著書=开著书
開著作=开著作
開著名=开著名
開著錄=开著录
開著稱=开著称
開著者=开著者
開著述=开著述
張法乾=张法乾
张法乾=张法乾
當著=当着
當著書=当著书
當著作=当著作
當著名=当著名
當著錄=当著录
當著稱=当著称
當著者=当著者
當著述=当著述
彰明較著=彰明较著
待覆=待复
待著=待着
待著书=待著书
待著書=待著书
待著作=待著作
待著名=待著名
待著录=待著录
待著錄=待著录
待著稱=待著称
待著称=待著称
待著者=待著者
待著述=待著述
後姓=後姓
得著=得着
得著書=得著书
得著书=得著书
得著作=得著作
得著名=得著名
得著錄=得著录
得著录=得著录
得著稱=得著称
得著称=得著称
得著者=得著者
得著述=得著述
循著=循着
循著书=循著书
循著書=循著书
循著作=循著作
循著名=循著名
循著录=循著录
循著錄=循著录
循著称=循著称
循著稱=循著称
循著者=循著者
循著述=循著述
心著=心着
心著书=心著书
心著書=心著书
心著作=心著作
心著名=心著名
心著录=心著录
心著錄=心著录
心著稱=心著称
心著称=心著称
心著者=心著者
心著述=心著述
忍著=忍着
忍著书=忍著书
忍著書=忍著书
忍著作=忍著作
忍著名=忍著名
忍著录=忍著录
忍著錄=忍著录
忍著稱=忍著称
忍著称=忍著称
忍著者=忍著者
忍著述=忍著述
志著=志着
志著書=志著书
志著书=志著书
志著作=志著作
志著名=志著名
志著錄=志著录
志著录=志著录
志著称=志著称
志著稱=志著称
志著者=志著者
志著述=志著述
忙著=忙着
忙著书=忙著书
忙著書=忙著书
忙著作=忙著作
忙著名=忙著名
忙著录=忙著录
忙著錄=忙著录
忙著称=忙著称
忙著稱=忙著称
忙著者=忙著者
忙著述=忙著述
懷著=怀着
懷著書=怀著书
懷著作=怀著作
懷著名=怀著名
懷著錄=怀著录
懷著稱=怀著称
懷著者=怀著者
懷著述=怀著述
急著=急着
急著书=急著书
急著書=急著书
急著作=急著作
急著名=急著名
急著录=急著录
急著錄=急著录
急著称=急著称
急著稱=急著称
急著者=急著者
急著述=急著述
性著=性着
性著书=性著书
性著書=性著书
性著作=性著作
性著名=性著名
性著录=性著录
性著錄=性著录
性著称=性著称
性著稱=性著称
性著者=性著者
性著述=性著述
戀著=恋着
戀著書=恋著书
戀著作=恋著作
戀著名=恋著名
戀著錄=恋著录
戀著稱=恋著称
戀著者=恋著者
戀著述=恋著述
恩威並著=恩威并著
悠著=悠着
悠著書=悠著书
悠著书=悠著书
悠著作=悠著作
悠著名=悠著名
悠著錄=悠著录
悠著录=悠著录
悠著称=悠著称
悠著稱=悠著称
悠著者=悠著者
悠著述=悠著述
慣著=惯着
慣著書=惯著书
慣著作=惯著作
慣著名=惯著名
慣著錄=惯著录
慣著稱=惯著称
慣著者=惯著者
慣著述=惯著述
想著=想着
想著書=想著书
想著书=想著书
想著作=想著作
想著名=想著名
想著錄=想著录
想著录=想著录
想著称=想著称
想著稱=想著称
想著者=想著者
想著述=想著述
戰著=战着
戰著書=战著书
戰著作=战著作
戰著名=战著名
戰著錄=战著录
戰著稱=战著称
戰著者=战著者
戰著述=战著述
戴著=戴着
戴著書=戴著书
戴著书=戴著书
戴著作=戴著作
戴著名=戴著名
戴著錄=戴著录
戴著录=戴著录
戴著稱=戴著称
戴著称=戴著称
戴著者=戴著者
戴著述=戴著述
扎著=扎着
扎著書=扎著书
扎著书=扎著书
扎著作=扎著作
扎著名=扎著名
扎著錄=扎著录
扎著录=扎著录
扎著称=扎著称
扎著稱=扎著称
扎著者=扎著者
扎著述=扎著述
打著=打着
打著書=打著书
打著书=打著书
打著作=打著作
打著名=打著名
打著錄=打著录
打著录=打著录
打著称=打著称
打著稱=打著称
打著者=打著者
打著述=打著述
扛著=扛着
扛著书=扛著书
扛著書=扛著书
扛著作=扛著作
扛著名=扛著名
扛著录=扛著录
扛著錄=扛著录
扛著称=扛著称
扛著稱=扛著称
扛著者=扛著者
扛著述=扛著述
執著=执著
批覆=批复
找不著=找不着
找得著=找得着
抓著=抓着
抓著作=抓著作
抓著名=抓著名
抓著录=抓著录
抓著錄=抓著录
抓著称=抓著称
抓著稱=抓著称
抓著者=抓著者
抓著述=抓著述
護著=护着
護著書=护著书
護著作=护著作
護著名=护著名
護著錄=护著录
護著稱=护著称
護著者=护著者
護著述=护著述
披著=披着
披著书=披著书
披著書=披著书
披著作=披著作
披著名=披著名
披著录=披著录
披著錄=披著录
披著稱=披著称
披著称=披著称
披著者=披著者
披著述=披著述
抬著=抬着
抬著作=抬著作
抬著名=抬著名
抬著录=抬著录
抬著錄=抬著录
抬著稱=抬著称
抬著称=抬著称
抬著者=抬著者
抬著述=抬著述
抱著=抱着
抱著作=抱著作
抱著名=抱著名
抱著录=抱著录
抱著錄=抱著录
抱著稱=抱著称
抱著称=抱著称
抱著者=抱著者
抱著述=抱著述
拉著=拉着
拉著书=拉著书
拉著書=拉著书
拉著作=拉著作
拉著名=拉著名
拉著录=拉著录
拉著錄=拉著录
拉著称=拉著称
拉著稱=拉著称
拉著者=拉著者
拉著述=拉著述
拉鍊=拉链
拎著=拎着
拎著作=拎著作
拎著名=拎著名
拎著錄=拎著录
拎著录=拎著录
拎著称=拎著称
拎著稱=拎著称
拎著者=拎著者
拎著述=拎著述
拖著=拖着
拖著作=拖著作
拖著名=拖著名
拖著錄=拖著录
拖著录=拖著录
拖著稱=拖著称
拖著称=拖著称
拖著者=拖著者
拖著述=拖著述
拙著=拙著
拚命=拚命
拚搏=拚搏
拚死=拚死
拼著=拼着
拼著作=拼著作
拼著名=拼著名
拼著录=拼著录
拼著錄=拼著录
拼著稱=拼著称
拼著称=拼著称
拼著者=拼著者
拼著述=拼著述
拿著=拿着
拿著作=拿著作
拿著名=拿著名
拿著录=拿著录
拿著錄=拿著录
拿著称=拿著称
拿著稱=拿著称
拿著者=拿著者
拿著述=拿著述
持著=持着
持著作=持著作
持著名=持著名
持著錄=持著录
持著录=持著录
持著称=持著称
持著稱=持著称
持著者=持著者
持著述=持著述
挑著=挑着
挑著作=挑著作
挑著名=挑著名
挑著錄=挑著录
挑著录=挑著录
挑著称=挑著称
挑著稱=挑著称
挑著者=挑著者
挑著述=挑著述
擋著=挡着
擋著作=挡著作
擋著名=挡著名
擋著錄=挡著录
擋著稱=挡著称
擋著者=挡著者
擋著述=挡著述
掙著=挣着
掙著書=挣著书
掙著作=挣著作
掙著名=挣著名
掙著錄=挣著录
掙著稱=挣著称
掙著者=挣著者
掙著述=挣著述
揮著=挥着
揮著作=挥著作
揮著名=挥著名
揮著錄=挥著录
揮著稱=挥著称
揮著者=挥著者
揮著述=挥著述
挨著=挨着
挨著作=挨著作
挨著名=挨著名
挨著錄=挨著录
挨著录=挨著录
挨著稱=挨著称
挨著称=挨著称
挨著者=挨著者
挨著述=挨著述
捆著=捆着
捆著作=捆著作
捆著名=捆著名
捆著錄=捆著录
捆著录=捆著录
捆著称=捆著称
捆著稱=捆著称
捆著者=捆著者
捆著述=捆著述
據著=据着
據著書=据著书
據著作=据著作
據著名=据著名
據著錄=据著录
據著稱=据著称
據著者=据著者
據著述=据著述
掖著=掖着
掖著作=掖著作
掖著名=掖著名
掖著錄=掖著录
掖著录=掖著录
掖著稱=掖著称
掖著称=掖著称
掖著者=掖著者
掖著述=掖著述
接著=接着
接著作=接著作
接著名=接著名
接著錄=接著录
接著录=接著录
接著稱=接著称
接著称=接著称
接著者=接著者
接著述=接著述
揉著=揉着
揉著书=揉著书
揉著書=揉著书
揉著作=揉著作
揉著名=揉著名
揉著录=揉著录
揉著錄=揉著录
揉著称=揉著称
揉著稱=揉著称
揉著者=揉著者
揉著述=揉著述
提著=提着
提著作=提著作
提著名=提著名
提著錄=提著录
提著录=提著录
提著稱=提著称
提著称=提著称
提著者=提著者
提著述=提著述
摟著=搂着
摟著作=搂著作
摟著名=搂著名
摟著錄=搂著录
摟著稱=搂著称
摟著者=搂著者
摟著述=搂著述
擺著=摆着
擺著作=摆著作
擺著名=摆著名
擺著錄=摆著录
擺著稱=摆著称
擺著者=摆著者
擺著述=摆著述
撰著=撰著
撼著=撼着
撼著書=撼著书
撼著书=撼著书
撼著作=撼著作
撼著名=撼著名
撼著錄=撼著录
撼著录=撼著录
撼著称=撼著称
撼著稱=撼著称
撼著者=撼著者
撼著述=撼著述
敞著=敞着
敞著作=敞著作
敞著名=敞著名
敞著錄=敞著录
敞著录=敞著录
敞著稱=敞著称
敞著称=敞著称
敞著者=敞著者
敞著述=敞著述
數著=数着
數著作=数著作
數著名=数著名
數著錄=数著录
數著稱=数著称
數著者=数著者
數著述=数著述
斗著=斗着
斗著書=斗著书
斗著书=斗著书
斗著作=斗著作
斗著名=斗著名
斗著錄=斗著录
斗著录=斗著录
斗著称=斗著称
斗著稱=斗著称
斗著者=斗著者
斗著述=斗著述
斥著=斥着
斥著書=斥著书
斥著书=斥著书
斥著作=斥著作
斥著名=斥著名
斥著錄=斥著录
斥著录=斥著录
斥著稱=斥著称
斥著称=斥著称
斥著者=斥著者
斥著述=斥著述
新著=新著
新著龍虎門=新著龙虎门
於世成=於世成
於乎=於乎
於乙于同=於乙于同
於乙宇同=於乙宇同
於于同=於于同
於哲=於哲
於夫罗=於夫罗
於夫羅=於夫罗
於姓=於姓
於宇同=於宇同
於崇文=於崇文
於志賀=於志贺
於志贺=於志贺
於戲=於戏
於梨華=於梨华
於梨华=於梨华
於氏=於氏
於潛縣=於潜县
於潜县=於潜县
於祥玉=於祥玉
於菟=於菟
於賢德=於贤德
於除鞬=於除鞬
旋乾转坤=旋乾转坤
旋乾轉坤=旋乾转坤
曠若發矇=旷若发矇
昂著=昂着
昂著书=昂著书
昂著書=昂著书
昂著作=昂著作
昂著名=昂著名
昂著錄=昂著录
昂著录=昂著录
昂著稱=昂著称
昂著称=昂著称
昂著者=昂著者
昂著述=昂著述
易·乾=易·乾
易經·乾=易经·乾
易经·乾=易经·乾
易經乾=易经乾
易经乾=易经乾
映著=映着
映著書=映著书
映著书=映著书
映著作=映著作
映著名=映著名
映著錄=映著录
映著录=映著录
映著稱=映著称
映著称=映著称
映著者=映著者
映著述=映著述
昭著=昭著
顯著=显著
显著=显著
晃著=晃着
晃著作=晃著作
晃著名=晃著名
晃著錄=晃著录
晃著录=晃著录
晃著称=晃著称
晃著稱=晃著称
晃著者=晃著者
晃著述=晃著述
暗著=暗着
暗著书=暗著书
暗著書=暗著书
暗著作=暗著作
暗著名=暗著名
暗著錄=暗著录
暗著录=暗著录
暗著称=暗著称
暗著稱=暗著称
暗著者=暗著者
暗著述=暗著述
有著=有着
有著書=有著书
有著书=有著书
有著作=有著作
有著名=有著名
有著錄=有著录
有著录=有著录
有著称=有著称
有著稱=有著称
有著者=有著者
有著述=有著述
望著=望着
望著作=望著作
望著名=望著名
望著录=望著录
望著錄=望著录
望著稱=望著称
望著称=望著称
望著者=望著者
望著述=望著述
朝乾夕惕=朝乾夕惕
朝著=朝着
朝著作=朝著作
朝著名=朝著名
朝著录=朝著录
朝著錄=朝著录
朝著稱=朝著称
朝著称=朝著称
朝著者=朝著者
朝著述=朝著述
本著=本着
本著书=本著书
本著書=本著书
本著作=本著作
本著名=本著名
本著录=本著录
本著錄=本著录
本著稱=本著称
本著称=本著称
本著者=本著者
本著述=本著述
朴於宇同=朴於宇同
殺著=杀着
殺著書=杀著书
殺著作=杀著作
殺著名=杀著名
殺著錄=杀著录
殺著稱=杀著称
殺著者=杀著者
殺著述=杀著述
雜著=杂着
雜著書=杂著书
雜著作=杂著作
雜著名=杂著名
雜著錄=杂著录
雜著稱=杂著称
雜著者=杂著者
雜著述=杂著述
李乾德=李乾德
李乾順=李乾顺
李乾顺=李乾顺
李澤鉅=李泽钜
來著=来着
來著書=来著书
來著作=来著作
來著名=来著名
來著錄=来著录
來著稱=来著称
來著者=来著者
來著述=来著述
楊幺=杨幺
枕著=枕着
枕著作=枕著作
枕著名=枕著名
枕著錄=枕著录
枕著录=枕著录
枕著稱=枕著称
枕著称=枕著称
枕著者=枕著者
枕著述=枕著述
柳詒徵=柳诒徵
柳诒徵=柳诒徵
標志著=标志着
標誌著=标志着
夢著=梦着
夢著書=梦著书
夢著作=梦著作
夢著名=梦著名
夢著錄=梦著录
夢著稱=梦著称
夢著者=梦著者
夢著述=梦著述
梳著=梳着
梳著作=梳著作
梳著名=梳著名
梳著錄=梳著录
梳著录=梳著录
梳著稱=梳著称
梳著称=梳著称
梳著者=梳著者
梳著述=梳著述
樊於期=樊於期
氆氌=氆氌
求著=求着
求著书=求著书
求著書=求著书
求著作=求著作
求著名=求著名
求著录=求著录
求著錄=求著录
求著称=求著称
求著稱=求著称
求著者=求著者
求著述=求著述
沈沒=沉没
沉著=沉着
沈積=沉积
沈船=沉船
沉著書=沉著书
沉著书=沉著书
沉著作=沉著作
沉著名=沉著名
沉著錄=沉著录
沉著录=沉著录
沉著称=沉著称
沉著稱=沉著称
沉著者=沉著者
沉著述=沉著述
沈默=沉默
沿著=沿着
沿著书=沿著书
沿著書=沿著书
沿著作=沿著作
沿著名=沿著名
沿著录=沿著录
沿著錄=沿著录
沿著稱=沿著称
沿著称=沿著称
沿著者=沿著者
沿著述=沿著述
氾濫=泛滥
洗鍊=洗练
活著=活着
活著书=活著书
活著書=活著书
活著作=活著作
活著名=活著名
活著录=活著录
活著錄=活著录
活著稱=活著称
活著称=活著称
活著者=活著者
活著述=活著述
流著=流着
流著书=流著书
流著書=流著书
流著作=流著作
流著名=流著名
流著录=流著录
流著錄=流著录
流著稱=流著称
流著称=流著称
流著者=流著者
流著述=流著述
流露著=流露着
浮著=浮着
浮著书=浮著书
浮著書=浮著书
浮著作=浮著作
浮著名=浮著名
浮著录=浮著录
浮著錄=浮著录
浮著稱=浮著称
浮著称=浮著称
浮著者=浮著者
浮著述=浮著述
潤著=润着
潤著書=润著书
潤著作=润著作
潤著名=润著名
潤著錄=润著录
潤著稱=润著称
潤著者=润著者
潤著述=润著述
涵著=涵着
涵著书=涵著书
涵著書=涵著书
涵著作=涵著作
涵著名=涵著名
涵著录=涵著录
涵著錄=涵著录
涵著稱=涵著称
涵著称=涵著称
涵著者=涵著者
涵著述=涵著述
渴著=渴着
渴著书=渴著书
渴著書=渴著书
渴著作=渴著作
渴著名=渴著名
渴著录=渴著录
渴著錄=渴著录
渴著称=渴著称
渴著稱=渴著称
渴著者=渴著者
渴著述=渴著述
溢著=溢着
溢著書=溢著书
溢著书=溢著书
溢著作=溢著作
溢著名=溢著名
溢著錄=溢著录
溢著录=溢著录
溢著称=溢著称
溢著稱=溢著称
溢著者=溢著者
溢著述=溢著述
演著=演着
演著书=演著书
演著書=演著书
演著作=演著作
演著名=演著名
演著录=演著录
演著錄=演著录
演著稱=演著称
演著称=演著称
演著者=演著者
演著述=演著述
漫著=漫着
漫著書=漫著书
漫著书=漫著书
漫著作=漫著作
漫著名=漫著名
漫著录=漫著录
漫著錄=漫著录
漫著称=漫著称
漫著稱=漫著称
漫著者=漫著者
漫著述=漫著述
點著=点着
點著作=点著作
點著名=点著名
點著錄=点著录
點著稱=点著称
點著者=点著者
點著述=点著述
燒著=烧着
燒著作=烧著作
燒著名=烧著名
燒著錄=烧著录
燒著稱=烧著称
燒著者=烧著者
燒著述=烧著述
照著=照着
照著书=照著书
照著書=照著书
照著作=照著作
照著名=照著名
照著录=照著录
照著錄=照著录
照著称=照著称
照著稱=照著称
照著者=照著者
照著述=照著述
愛護著=爱护着
愛著=爱着
愛著書=爱著书
愛著作=爱著作
愛著名=爱著名
愛著錄=爱著录
愛著稱=爱著称
愛著者=爱著者
愛著述=爱著述
牽著=牵着
牽著書=牵著书
牽著作=牵著作
牽著名=牵著名
牽著錄=牵著录
牽著稱=牵著称
牽著者=牵著者
牽著述=牵著述
犯不著=犯不着
犯得著=犯得着
獨著=独着
獨著書=独著书
獨著作=独著作
獨著名=独著名
獨著錄=独著录
獨著稱=独著称
獨著者=独著者
獨著述=独著述
猜著=猜着
猜著書=猜着书
猜著作=猜著作
猜著名=猜著名
猜著錄=猜著录
猜著录=猜著录
猜著称=猜著称
猜著稱=猜著称
猜著者=猜著者
猜著述=猜著述
王道乾=王道乾
玩著=玩着
甜著=甜着
甜著書=甜著书
甜著书=甜著书
甜著作=甜著作
甜著名=甜著名
甜著录=甜著录
甜著錄=甜著录
甜著稱=甜著称
甜著称=甜著称
甜著者=甜著者
甜著述=甜著述
用不著=用不着
用得著=用得着
用著=用着
用著书=用著书
用著書=用著书
用著作=用著作
用著名=用著名
用著录=用著录
用著錄=用著录
用著称=用著称
用著稱=用著称
用著者=用著者
用著述=用著述
男为乾=男为乾
男爲乾=男为乾
男為乾=男为乾
男性為乾=男性为乾
男性爲乾=男性为乾
男性为乾=男性为乾
留著=留着
留著書=留着书
留著作=留著作
留著名=留著名
留著錄=留著录
留著录=留著录
留著稱=留著称
留著称=留著称
留著者=留著者
留著述=留著述
疑著=疑着
疑著书=疑著书
疑著書=疑著书
疑著作=疑著作
疑著名=疑著名
疑著录=疑著录
疑著錄=疑著录
疑著称=疑著称
疑著稱=疑著称
疑著者=疑著者
疑著述=疑著述
癥瘕=癥瘕
皺著=皱着
皺著書=皱著书
皺著作=皱著作
皺著名=皱著名
皺著錄=皱著录
皺著稱=皱著称
皺著者=皱著者
皺著述=皱著述
盛著=盛着
盛著书=盛著书
盛著書=盛著书
盛著作=盛著作
盛著名=盛著名
盛著錄=盛著录
盛著录=盛著录
盛著稱=盛著称
盛著称=盛著称
盛著者=盛著者
盛著述=盛著述
盯著=盯着
盯著書=盯着书
盯著作=盯著作
盯著名=盯著名
盯著錄=盯著录
盯著录=盯著录
盯著稱=盯著称
盯著称=盯著称
盯著者=盯著者
盯著述=盯著述
盾著=盾着
盾著書=盾著书
盾著书=盾著书
盾著作=盾著作
盾著名=盾著名
盾著錄=盾著录
盾著录=盾著录
盾著稱=盾著称
盾著称=盾著称
盾著者=盾著者
盾著述=盾著述
看不著=看不着
看得著=看得着
看著=看着
看著書=看着书
看著作=看著作
看著名=看著名
看著录=看著录
看著錄=看著录
看著稱=看著称
看著称=看著称
看著者=看著者
看著述=看著述
著業=着业
著絲=着丝
著么=着么
著人=着人
著什么急=着什么急
著他=着他
著令=着令
著位=着位
著體=着体
著你=着你
著便=着便
著涼=着凉
著力=着力
著勁=着劲
著號=着号
著呢=着呢
著哩=着哩
著地=着地
著墨=着墨
著聲=着声
著處=着处
著她=着她
著妳=着妳
著姓=着姓
著它=着它
著定=着定
著實=着实
著己=着己
著帳=着帐
著床=着床
著庸=着庸
著式=着式
著錄=着录
著心=着心
著志=着志
著忙=着忙
著急=着急
著惱=着恼
著驚=着惊
著想=着想
著意=着意
著慌=着慌
著我=着我
著手=着手
著抹=着抹
著摸=着摸
著撰=着撰
著數=着数
著明=着明
著末=着末
著極=着极
著格=着格
著棋=着棋
著槁=着槁
著氣=着气
著法=着法
著淺=着浅
著火=着火
著然=着然
著甚=着甚
著生=着生
著疑=着疑
著白=着白
著相=着相
著眼=着眼
著著=着着
著祂=着祂
著積=着积
著稿=着稿
著筆=着笔
著籍=着籍
著緊=着紧
著緑=着緑
著絆=着绊
著績=着绩
著緋=着绯
著綠=着绿
著肉=着肉
著腳=着脚
著艦=着舰
著色=着色
著節=着节
著花=着花
著莫=着莫
著落=着落
著藁=着藁
著衣=着衣
著裝=着装
著要=着要
著警=着警
著趣=着趣
著邊=着边
著迷=着迷
著跡=着迹
著重=着重
著録=着録
著聞=着闻
著陸=着陆
著雝=着雝
著鞭=着鞭
著題=着题
著魔=着魔
睡不著=睡不着
睡得著=睡得着
睡著=睡着
睡著書=睡著书
睡著书=睡著书
睡著作=睡著作
睡著名=睡著名
睡著錄=睡著录
睡著录=睡著录
睡著称=睡著称
睡著稱=睡著称
睡著者=睡著者
睡著述=睡著述
睹微知著=睹微知著
睪丸=睾丸
瞞著=瞒着
瞞著書=瞒著书
瞞著作=瞒著作
瞞著名=瞒著名
瞞著錄=瞒著录
瞞著稱=瞒著称
瞞著者=瞒著者
瞞著述=瞒著述
瞧著=瞧着
瞧著書=瞧着书
瞧著作=瞧著作
瞧著名=瞧著名
瞧著录=瞧著录
瞧著錄=瞧著录
瞧著称=瞧著称
瞧著稱=瞧著称
瞧著者=瞧著者
瞧著述=瞧著述
瞪著=瞪着
瞪著書=瞪著书
瞪著书=瞪著书
瞪著作=瞪著作
瞪著名=瞪著名
瞪著錄=瞪著录
瞪著录=瞪著录
瞪著称=瞪著称
瞪著稱=瞪著称
瞪著者=瞪著者
瞪著述=瞪著述
瞭望=瞭望
石碁镇=石碁镇
石碁鎮=石碁镇
福著=福着
福著书=福著书
福著書=福著书
福著作=福著作
福著名=福著名
福著錄=福著录
福著录=福著录
福著稱=福著称
福著称=福著称
福著者=福著者
福著述=福著述
穀梁=穀梁
空著=空着
空著书=空著书
空著書=空著书
空著作=空著作
空著名=空著名
空著录=空著录
空著錄=空著录
空著称=空著称
空著稱=空著称
空著者=空著者
空著述=空著述
穿著=穿着
穿著书=穿著书
穿著書=穿著书
穿著作=穿著作
穿著名=穿著名
穿著录=穿著录
穿著錄=穿著录
穿著称=穿著称
穿著稱=穿著称
穿著者=穿著者
穿著述=穿著述
豎著=竖着
豎著書=竖著书
豎著作=竖著作
豎著名=竖著名
豎著錄=竖著录
豎著稱=竖著称
豎著者=竖著者
豎著述=竖著述
站著=站着
站著书=站著书
站著書=站著书
站著作=站著作
站著名=站著名
站著錄=站著录
站著录=站著录
站著称=站著称
站著稱=站著称
站著者=站著者
站著述=站著述
笑著=笑着
笑著书=笑著书
笑著書=笑著书
笑著作=笑著作
笑著名=笑著名
笑著录=笑著录
笑著錄=笑著录
笑著称=笑著称
笑著稱=笑著称
笑著者=笑著者
笑著述=笑著述
答覆=答复
管著=管着
管著书=管著书
管著書=管著书
管著作=管著作
管著名=管著名
管著录=管著录
管著錄=管著录
管著稱=管著称
管著称=管著称
管著者=管著者
管著述=管著述
米澤瑠美=米泽瑠美
米泽瑠美=米泽瑠美
綁著=绑着
綁著書=绑著书
綁著作=绑著作
綁著名=绑著名
綁著錄=绑著录
綁著稱=绑著称
綁著者=绑著者
綁著述=绑著述
繞著=绕着
繞著書=绕著书
繞著作=绕著作
繞著名=绕著名
繞著錄=绕著录
繞著稱=绕著称
繞著者=绕著者
繞著述=绕著述
編著=编著
纏著=缠着
纏著書=缠著书
纏著作=缠著作
纏著名=缠著名
纏著錄=缠著录
纏著稱=缠著称
纏著者=缠著者
纏著述=缠著述
罩著=罩着
罩著书=罩著书
罩著書=罩著书
罩著作=罩著作
罩著名=罩著名
罩著錄=罩著录
罩著录=罩著录
罩著称=罩著称
罩著稱=罩著称
罩著者=罩著者
罩著述=罩著述
美著=美着
美著书=美著书
美著書=美著书
美著作=美著作
美著名=美著名
美著录=美著录
美著錄=美著录
美著稱=美著称
美著称=美著称
美著者=美著者
美著述=美著述
耀著=耀着
耀著書=耀著书
耀著书=耀著书
耀著作=耀著作
耀著名=耀著名
耀著錄=耀著录
耀著录=耀著录
耀著称=耀著称
耀著稱=耀著称
耀著者=耀著者
耀著述=耀著述
老幺=老幺
考著=考着
考著書=考著书
考著书=考著书
考著作=考著作
考著名=考著名
考著錄=考著录
考著录=考著录
考著稱=考著称
考著称=考著称
考著者=考著者
考著述=考著述
肉乾乾=肉干干
肘手鍊足=肘手链足
背著=背着
背著书=背著书
背著書=背著书
背著作=背著作
背著名=背著名
背著录=背著录
背著錄=背著录
背著称=背著称
背著稱=背著称
背著者=背著者
背著述=背著述
膠著=胶着
膠著書=胶著书
膠著作=胶著作
膠著名=胶著名
膠著錄=胶著录
膠著稱=胶著称
膠著者=胶著者
膠著述=胶著述
藝著=艺着
藝著書=艺著书
藝著作=艺著作
藝著名=艺著名
藝著錄=艺著录
藝著稱=艺著称
藝著者=艺著者
藝著述=艺著述
苦著=苦着
苦著书=苦著书
苦著書=苦著书
苦著作=苦著作
苦著名=苦著名
苦著录=苦著录
苦著錄=苦著录
苦著稱=苦著称
苦著称=苦著称
苦著者=苦著者
苦著述=苦著述
苧烯=苧烯
薴烯=苧烯
獲著=获着
獲著書=获著书
獲著作=获著作
獲著名=获著名
獲著錄=获著录
獲著稱=获著称
獲著者=获著者
獲著述=获著述
蕭乾=萧乾
萧乾=萧乾
落著=落着
落著书=落著书
落著書=落著书
落著作=落著作
落著名=落著名
落著录=落著录
落著錄=落著录
落著稱=落著称
落著称=落著称
落著者=落著者
落著述=落著述
著書=著书
著書立說=著书立说
著作=著作
著名=著名
著錄規則=著录规则
著文=著文
著有=著有
著稱=著称
著者=著者
著身=著身
著述=著述
蒙著=蒙着
蒙著書=蒙著书
蒙著书=蒙著书
蒙著作=蒙著作
蒙著名=蒙著名
蒙著录=蒙著录
蒙著錄=蒙著录
蒙著稱=蒙著称
蒙著称=蒙著称
蒙著者=蒙著者
蒙著述=蒙著述
藏著=藏着
藏著書=藏著书
藏著书=藏著书
藏著作=藏著作
藏著名=藏著名
藏著錄=藏著录
藏著录=藏著录
藏著称=藏著称
藏著稱=藏著称
藏著者=藏著者
藏著述=藏著述
蘸著=蘸着
蘸著書=蘸著书
蘸著书=蘸著书
蘸著作=蘸著作
蘸著名=蘸著名
蘸著录=蘸著录
蘸著錄=蘸著录
蘸著稱=蘸著称
蘸著称=蘸著称
蘸著者=蘸著者
蘸著述=蘸著述
行著=行着
行著书=行著书
行著書=行著书
行著作=行著作
行著名=行著名
行著录=行著录
行著錄=行著录
行著稱=行著称
行著称=行著称
行著者=行著者
行著述=行著述
衣著=衣着
衣著书=衣著书
衣著書=衣著书
衣著作=衣著作
衣著名=衣著名
衣著录=衣著录
衣著錄=衣著录
衣著稱=衣著称
衣著称=衣著称
衣著者=衣著者
衣著述=衣著述
裝著=装着
裝著書=装著书
裝著作=装著作
裝著名=装著名
裝著錄=装著录
裝著稱=装著称
裝著者=装著者
裝著述=装著述
裹著=裹着
裹著書=裹著书
裹著书=裹著书
裹著作=裹著作
裹著名=裹著名
裹著录=裹著录
裹著錄=裹著录
裹著称=裹著称
裹著稱=裹著称
裹著者=裹著者
裹著述=裹著述
覆蓋=覆蓋
見微知著=见微知著
見著=见着
見著書=见著书
見著作=见著作
見著名=见著名
見著錄=见著录
見著稱=见著称
見著者=见著者
見著述=见著述
視微知著=视微知著
言幾析理=言幾析理
警戒著=警戒着
記著=记着
記著書=记著书
記著作=记著作
記著名=记著名
記著錄=记著录
記著稱=记著称
記著者=记著者
記著述=记著述
論著=论著
譯著=译著
試著=试着
試著書=试著书
試著作=试著作
試著名=试著名
試著錄=试著录
試著稱=试著称
試著者=试著者
試著述=试著述
語著=语着
語著書=语著书
語著作=语著作
語著名=语著名
語著錄=语著录
語著稱=语著称
語著者=语著者
語著述=语著述
豫著=豫着
豫著书=豫著书
豫著書=豫著书
豫著作=豫著作
豫著名=豫著名
豫著录=豫著录
豫著錄=豫著录
豫著称=豫著称
豫著稱=豫著称
豫著者=豫著者
豫著述=豫著述
貞著=贞着
貞著書=贞著书
貞著作=贞著作
貞著名=贞著名
貞著錄=贞著录
貞著稱=贞著称
貞著者=贞著者
貞著述=贞著述
走著=走着
走著書=走著书
走著书=走著书
走著作=走著作
走著名=走著名
走著錄=走著录
走著录=走著录
走著稱=走著称
走著称=走著称
走著者=走著者
走著述=走著述
趕著=赶着
趕著書=赶著书
趕著作=赶著作
趕著名=赶著名
趕著錄=赶著录
趕著稱=赶著称
趕著者=赶著者
趕著述=赶著述
趴著=趴着
趴著書=趴著书
趴著书=趴著书
趴著作=趴著作
趴著名=趴著名
趴著录=趴著录
趴著錄=趴著录
趴著称=趴著称
趴著稱=趴著称
趴著者=趴著者
趴著述=趴著述
躍著=跃着
躍著書=跃著书
躍著作=跃著作
躍著名=跃著名
躍著錄=跃著录
躍著稱=跃著称
躍著者=跃著者
躍著述=跃著述
跑著=跑着
跑著書=跑著书
跑著书=跑著书
跑著作=跑著作
跑著名=跑著名
跑著录=跑著录
跑著錄=跑著录
跑著稱=跑著称
跑著称=跑著称
跑著者=跑著者
跑著述=跑著述
跟著=跟着
跟著书=跟著书
跟著書=跟著书
跟著作=跟著作
跟著名=跟著名
跟著录=跟著录
跟著錄=跟著录
跟著称=跟著称
跟著稱=跟著称
跟著者=跟著者
跟著述=跟著述
跪著=跪着
跪著書=跪著书
跪著书=跪著书
跪著作=跪著作
跪著名=跪著名
跪著錄=跪著录
跪著录=跪著录
跪著稱=跪著称
跪著称=跪著称
跪著者=跪著者
跪著述=跪著述
跳著=跳着
跳著书=跳著书
跳著書=跳著书
跳著作=跳著作
跳著名=跳著名
跳著录=跳著录
跳著錄=跳著录
跳著称=跳著称
跳著稱=跳著称
跳著者=跳著者
跳著述=跳著述
躊躇滿志=踌躇滿志
踏著=踏着
踏著書=踏著书
踏著书=踏著书
踏著作=踏著作
踏著名=踏著名
踏著錄=踏著录
踏著录=踏著录
踏著称=踏著称
踏著稱=踏著称
踏著者=踏著者
踏著述=踏著述
踩著=踩着
踩著书=踩著书
踩著書=踩著书
踩著作=踩著作
踩著名=踩著名
踩著录=踩著录
踩著錄=踩著录
踩著稱=踩著称
踩著称=踩著称
踩著者=踩著者
踩著述=踩著述
身著=身着
身著书=身著书
身著書=身著书
身著作=身著作
身著名=身著名
身著录=身著录
身著錄=身著录
身著稱=身著称
身著称=身著称
身著者=身著者
身著述=身著述
躺著=躺着
躺著書=躺著书
躺著书=躺著书
躺著作=躺著作
躺著名=躺著名
躺著錄=躺著录
躺著录=躺著录
躺著称=躺著称
躺著稱=躺著称
躺著者=躺著者
躺著述=躺著述
轉著=转着
轉著書=转著书
轉著作=转著作
轉著名=转著名
轉著錄=转著录
轉著稱=转著称
轉著者=转著者
轉著述=转著述
載著=载着
載著書=载著书
載著作=载著作
載著名=载著名
載著錄=载著录
載著稱=载著称
載著者=载著者
載著述=载著述
較著=较著
達著=达着
達著書=达著书
達著作=达著作
達著名=达著名
達著錄=达著录
達著稱=达著称
達著者=达著者
達著述=达著述
近角聪信=近角聪信
近角聰信=近角聪信
遠著=远着
遠著書=远著书
遠著作=远著作
遠著名=远著名
遠著錄=远著录
遠著稱=远著称
遠著者=远著者
遠著述=远著述
連著=连着
連著書=连著书
連著作=连著作
連著名=连著名
連著錄=连著录
連著稱=连著称
連著者=连著者
連著述=连著述
迫著=迫着
追著=追着
追著書=追著书
追著书=追著书
追著作=追著作
追著名=追著名
追著錄=追著录
追著录=追著录
追著称=追著称
追著稱=追著称
追著者=追著者
追著述=追著述
逆著=逆着
逆著書=逆著书
逆著书=逆著书
逆著作=逆著作
逆著名=逆著名
逆著錄=逆著录
逆著录=逆著录
逆著称=逆著称
逆著稱=逆著称
逆著者=逆著者
逆著述=逆著述
逼著=逼着
逼著書=逼著书
逼著书=逼著书
逼著作=逼著作
逼著名=逼著名
逼著錄=逼著录
逼著录=逼著录
逼著称=逼著称
逼著稱=逼著称
逼著者=逼著者
逼著述=逼著述
遇著=遇着
遇著書=遇著书
遇著书=遇著书
遇著作=遇著作
遇著名=遇著名
遇著錄=遇著录
遇著录=遇著录
遇著稱=遇著称
遇著称=遇著称
遇著者=遇著者
遇著述=遇著述
遺著=遗著
那麽=那麽
郭子乾=郭子乾
配著=配着
配著書=配著书
配著书=配著书
配著作=配著作
配著名=配著名
配著錄=配著录
配著录=配著录
配著稱=配著称
配著称=配著称
配著者=配著者
配著述=配著述
釀著=酿着
釀著書=酿著书
釀著作=酿著作
釀著名=酿著名
釀著錄=酿著录
釀著稱=酿著称
釀著者=酿著者
釀著述=酿著述
醯壺=醯壶
醯壶=醯壶
醯醬=醯酱
醯酱=醯酱
醯醋=醯醋
醯醢=醯醢
醯鸡=醯鸡
醯雞=醯鸡
重覆=重复
金鍊=金链
鐵鍊=铁链
鉸鍊=铰链
銀鍊=银链
鋪著=铺着
鋪著書=铺著书
鋪著作=铺著作
鋪著名=铺著名
鋪著錄=铺著录
鋪著稱=铺著称
鋪著者=铺著者
鋪著述=铺著述
鍊子=链子
鍊條=链条
鍊鎖=链锁
鍊錘=链锤
鎖鍊=锁链
鍾鍛=锺锻
鍛鍾=锻锺
閻懷禮=闫怀礼
閉著=闭着
閉著書=闭著书
閉著作=闭著作
閉著名=闭著名
閉著錄=闭著录
閉著稱=闭著称
閉著者=闭著者
閉著述=闭著述
閑著=闲着
閑著書=闲著书
閑著作=闲著作
閑著名=闲著名
閑著錄=闲著录
閑著稱=闲著称
閑著者=闲著者
閑著述=闲著述
聞不著=闻不着
聞得著=闻得着
聞著=闻着
阳为乾=阳为乾
陽爲乾=阳为乾
陽為乾=阳为乾
阿部正瞭=阿部正瞭
附著=附着
附睪=附睾
附著书=附著书
附著書=附著书
附著作=附著作
附著名=附著名
附著錄=附著录
附著录=附著录
附著称=附著称
附著稱=附著称
附著者=附著者
附著述=附著述
陈乾生=陈乾生
陳乾生=陈乾生
陈公乾生=陈公乾生
陳公乾生=陈公乾生
陋著=陋着
陋著書=陋著书
陋著书=陋著书
陋著作=陋著作
陋著名=陋著名
陋著錄=陋著录
陋著录=陋著录
陋著称=陋著称
陋著稱=陋著称
陋著者=陋著者
陋著述=陋著述
陪著=陪着
陪著书=陪著书
陪著書=陪著书
陪著作=陪著作
陪著名=陪著名
陪著录=陪著录
陪著錄=陪著录
陪著称=陪著称
陪著稱=陪著称
陪著者=陪著者
陪著述=陪著述
陳堵=陳堵
陳禕=陳禕
隨著=随着
隨著書=随著书
隨著作=随著作
隨著名=随著名
隨著錄=随著录
隨著稱=随著称
隨著者=随著者
隨著述=随著述
隔著=隔着
隔著书=隔著书
隔著書=隔著书
隔著作=隔著作
隔著名=隔著名
隔著录=隔著录
隔著錄=隔著录
隔著称=隔著称
隔著稱=隔著称
隔著者=隔著者
隔著述=隔著述
隱睪=隱睾
雅著=雅着
雅著书=雅著书
雅著書=雅著书
雅著作=雅著作
雅著名=雅著名
雅著录=雅著录
雅著錄=雅著录
雅著称=雅著称
雅著稱=雅著称
雅著者=雅著者
雅著述=雅著述
雍乾=雍乾
靠著=靠着
靠著作=靠著作
靠著名=靠著名
靠著錄=靠著录
靠著录=靠著录
靠著稱=靠著称
靠著称=靠著称
靠著者=靠著者
靠著述=靠著述
頂著=顶着
頂著書=顶著书
頂著作=顶著作
頂著名=顶著名
頂著錄=顶著录
頂著稱=顶著称
頂著者=顶著者
頂著述=顶著述
項鍊=项链
順著=顺着
順著書=顺著书
順著作=顺著作
順著名=顺著名
順著錄=顺著录
順著稱=顺著称
順著者=顺著者
順著述=顺著述
領著=领着
領著書=领著书
領著作=领著作
領著名=领著名
領著錄=领著录
領著稱=领著称
領著者=领著者
領著述=领著述
飄著=飘着
飄著書=飘著书
飄著作=飘著作
飄著名=飘著名
飄著錄=飘著录
飄著稱=飘著称
飄著者=飘著者
飄著述=飘著述
飭令=飭令
駕著=驾着
駕著書=驾著书
駕著作=驾著作
駕著名=驾著名
駕著錄=驾著录
駕著稱=驾著称
駕著者=驾著者
駕著述=驾著述
罵著=骂着
罵著書=骂著书
罵著作=骂著作
罵著名=骂著名
罵著錄=骂著录
罵著稱=骂著称
罵著者=骂著者
罵著述=骂著述
騎著=骑着
騎著書=骑著书
騎著作=骑著作
騎著名=骑著名
騎著錄=骑著录
騎著稱=骑著称
騎著者=骑著者
騎著述=骑著述
騙著=骗着
騙著書=骗著书
騙著作=骗著作
騙著名=骗著名
騙著錄=骗著录
騙著稱=骗著称
騙著者=骗著者
騙著述=骗著述
高著=高着
高著书=高著书
高著書=高著书
高著作=高著作
高著名=高著名
高著录=高著录
高著錄=高著录
高著稱=高著称
高著称=高著称
高著者=高著者
高著述=高著述
髭著=髭着
髭著书=髭著书
髭著書=髭著书
髭著作=髭著作
髭著名=髭著名
髭著錄=髭著录
髭著录=髭著录
髭著称=髭著称
髭著稱=髭著称
髭著者=髭著者
髭著述=髭著述
鬱姓=鬱姓
鬱氏=鬱氏
魏徵=魏徵
魚乾乾=鱼干干
鯰魚=鲶鱼
麯崇裕=麯崇裕
麴義=麴义
麴义=麴义
麴英=麴英
麽氏=麽氏
麽麽=麽麽
麼麼=麽麽
黄润乾=黄润乾
黃潤乾=黄润乾
黏著=黏着
黏著书=黏著书
黏著書=黏著书
黏著作=黏著作
黏著名=黏著名
黏著录=黏著录
黏著錄=黏著录
黏著称=黏著称
黏著稱=黏著称
黏著者=黏著者
黏著述=黏著述
);

$zh2TW = array(
“=「
”=」
‘=『
’=』
三極管=三極體
三极管=三極體
世界裏=世界裡
中文裏=中文裡
串行=串列
串列加速器=串列加速器
以太网=乙太網
奶酪=乳酪
二極管=二極體
二极管=二極體
交互式=互動式
阿塞拜疆=亞塞拜然
人工智能=人工智慧
接口=介面
服务器=伺服器
字節=位元組
字节=位元組
作品裏=作品裡
信道=信道
优先级=優先順序
元兇=元凶
元凶=元凶
光盘=光碟
光驱=光碟機
克羅地亞=克羅埃西亞
克罗地亚=克羅埃西亞
全角=全形
冬天裏=冬天裡
冬日裏=冬日裡
凉菜=冷盤
冷菜=冷盤
凶器=凶器
兇器=凶器
凶徒=凶徒
兇徒=凶徒
兇手=凶手
凶手=凶手
兇案=凶案
凶案=凶案
凶殘=凶殘
兇殘=凶殘
凶残=凶殘
兇殺=凶殺
凶杀=凶殺
凶殺=凶殺
打印=列印
列支敦士登=列支敦斯登
剪彩=剪綵
加蓬=加彭
总线=匯流排
局域网=區域網
特立尼達和多巴哥=千里達托貝哥
特立尼达和托巴哥=千里達托貝哥
半角=半形
卡塔爾=卡達
卡塔尔=卡達
打印機=印表機
打印机=印表機
厄立特里亞=厄利垂亞
厄立特里亚=厄利垂亞
厄瓜多尔=厄瓜多
厄瓜多爾=厄瓜多
斯威士兰=史瓦濟蘭
斯威士蘭=史瓦濟蘭
吉布提=吉布地
吉布堤=吉布地
基里巴斯=吉里巴斯
圖瓦盧=吐瓦魯
图瓦卢=吐瓦魯
哈萨克斯坦=哈薩克
哥斯達黎加=哥斯大黎加
哥斯达黎加=哥斯大黎加
格魯吉亞=喬治亞
格鲁吉亚=喬治亞
佐治亚=喬治亞
佐治亞=喬治亞
嘴裏=嘴裡
土库曼斯坦=土庫曼
薯仔=土豆
土豆網=土豆網
土豆网=土豆網
坦桑尼亚=坦尚尼亞
坦桑尼亞=坦尚尼亞
端口=埠
塔吉克斯坦=塔吉克
塞舌尔=塞席爾
塞舌爾=塞席爾
塞浦路斯=塞普勒斯
夏天裏=夏天裡
夏日裏=夏日裡
多明尼加共和國=多明尼加
多米尼加共和国=多明尼加
多米尼加共和國=多明尼加
多米尼加国=多米尼克
多明尼加國=多米尼克
穿梭機=太空梭
航天飞机=太空梭
尼日利亚=奈及利亞
尼日利亞=奈及利亞
字符=字元
字号=字型大小
字库=字型檔
字符集=字符集
存盘=存檔
學裏=學裡
安提瓜和巴布達=安地卡及巴布達
安提瓜和巴布达=安地卡及巴布達
宋元=宋元
洪都拉斯=宏都拉斯
寻址=定址
寒假裏=寒假裡
宽带=寬頻
老撾=寮國
老挝=寮國
打门=射門
專輯裏=專輯裡
贊比亞=尚比亞
赞比亚=尚比亞
尼日爾=尼日
尼日尔=尼日
山洞裏=山洞裡
巴布亞新畿內亞=巴布亞紐幾內亞
巴布亚新几内亚=巴布亞紐幾內亞
巴巴多斯=巴貝多
布基纳法索=布吉納法索
布基納法索=布吉納法索
布什=布希
布殊=布希
帕劳=帛琉
例程=常式
平治之乱=平治之亂
平治之亂=平治之亂
年代裏=年代裡
几内亚比绍=幾內亞比索
幾內亞比紹=幾內亞比索
彩带=彩帶
彩排=彩排
彩楼=彩樓
彩牌楼=彩牌樓
復蘇=復甦
复苏=復甦
心裏=心裡
快闪存储器=快閃記憶體
闪存=快閃記憶體
想象=想像
传感=感測
习用=慣用
戏彩娱亲=戲綵娛親
戲裏=戲裡
手电筒=手電筒
手电=手電筒
括号=括弧
拿破侖=拿破崙
拿破仑=拿破崙
積架=捷豹
扫瞄仪=掃瞄器
挂钩=掛鉤
掛鈎=掛鉤
控件=控制項
台球=撞球
桌球=撞球
便携式=攜帶型
故事裏=故事裡
调制解调器=數據機
調制解調器=數據機
斯洛文尼亞=斯洛維尼亞
斯洛文尼亚=斯洛維尼亞
新纪元=新紀元
新紀元=新紀元
日子裏=日子裡
春假裏=春假裡
春天裏=春天裡
春日裏=春日裡
時間裏=時間裡
芯片=晶元
暑假裏=暑假裡
村子裏=村子裡
乍得=查德
克林頓=柯林頓
克林顿=柯林頓
格林納達=格瑞那達
格林纳达=格瑞那達
凡高=梵谷
森林裏=森林裡
棺材裏=棺材裡
榴蓮=榴槤
榴莲=榴槤
仿真=模擬
毛里裘斯=模里西斯
毛里求斯=模里西斯
機械人=機器人
机器人=機器人
字段=欄位
歷史裏=歷史裡
元音=母音
永历=永曆
文莱=汶萊
沙特阿拉伯=沙烏地阿拉伯
沙地阿拉伯=沙烏地阿拉伯
波斯尼亞黑塞哥維那=波士尼亞赫塞哥維納
波斯尼亚和黑塞哥维那=波士尼亞赫塞哥維納
博茨瓦纳=波札那
博茨瓦納=波札那
流程控制=流程控制
侯赛因=海珊
侯賽因=海珊
深淵裏=深淵裡
光标=游標
鼠标=滑鼠
算法=演算法
乌兹别克斯坦=烏茲別克
词组=片語
獄裏=獄裡
塞拉利昂=獅子山
危地马拉=瓜地馬拉
危地馬拉=瓜地馬拉
冈比亚=甘比亞
岡比亞=甘比亞
疑兇=疑凶
疑凶=疑凶
百科裏=百科裡
皮裏陽秋=皮裡陽秋
盧旺達=盧安達
卢旺达=盧安達
真凶=真凶
真兇=真凶
眼睛裏=眼睛裡
硅片=矽片
硅谷=矽谷
硬盘=硬碟
硬件=硬體
盘片=碟片
磁盘=磁碟
磁道=磁軌
秋假裏=秋假裡
秋天裏=秋天裡
秋日裏=秋日裡
程控=程式控制
突尼斯=突尼西亞
尾注=章節附註
蹦极跳=笨豬跳
绑紧跳=笨豬跳
等于=等於
短訊=簡訊
短信=簡訊
系列裏=系列裡
新西蘭=紐西蘭
新西兰=紐西蘭
所罗门群岛=索羅門群島
所羅門群島=索羅門群島
索馬里=索馬利亞
索马里=索馬利亞
结彩=結綵
佛得角=維德角
網絡=網路
网络=網路
互聯網=網際網路
因特网=網際網路
彩球=綵球
彩绸=綵綢
彩线=綵線
彩船=綵船
彩衣=綵衣
缉凶=緝凶
緝兇=緝凶
緝凶=緝凶
意大利=義大利
老字号=老字號
圣基茨和尼维斯=聖克里斯多福及尼維斯
聖吉斯納域斯=聖克里斯多福及尼維斯
聖文森特和格林納丁斯=聖文森及格瑞那丁
圣文森特和格林纳丁斯=聖文森及格瑞那丁
圣卢西亚=聖露西亞
聖盧西亞=聖露西亞
圣马力诺=聖馬利諾
聖馬力諾=聖馬利諾
肚裏=肚裡
肯尼亚=肯亞
肯雅=肯亞
航天大学=航天大學
苦裏=苦裡
毛里塔尼亚=茅利塔尼亞
毛里塔尼亞=茅利塔尼亞
莫桑比克=莫三比克
万历=萬曆
瓦努阿图=萬那杜
瓦努阿圖=萬那杜
也门=葉門
也門=葉門
着=著
科摩羅=葛摩
科摩罗=葛摩
布隆迪=蒲隆地
圭亞那=蓋亞那
圭亚那=蓋亞那
火锅盖帽=蓋火鍋
苏里南=蘇利南
行凶=行凶
行兇=行凶
行凶后=行凶後
行兇後=行凶後
行凶後=行凶後
流動電話=行動電話
移动电话=行動電話
行程控制=行程控制
衞=衛
卫生=衛生
衞生=衛生
埃塞俄比亚=衣索比亞
埃塞俄比亞=衣索比亞
裏勾外連=裡勾外連
裏面=裡面
分辨率=解析度
译码=解碼
出租车=計程車
权限=許可權
瑙鲁=諾魯
瑙魯=諾魯
变量=變數
科特迪瓦=象牙海岸
貝寧=貝南
贝宁=貝南
伯利茲=貝里斯
伯利兹=貝里斯
買兇=買凶
买凶=買凶
買凶=買凶
数据库=資料庫
信息论=資訊理論
奔驰=賓士
平治=賓士
利比里亚=賴比瑞亞
利比里亞=賴比瑞亞
萊索托=賴索托
莱索托=賴索托
软驱=軟碟機
軟件=軟體
软件=軟體
加载=載入
津巴布韦=辛巴威
津巴布韋=辛巴威
词汇=辭彙
加纳=迦納
加納=迦納
追凶=追凶
追兇=追凶
這裏=這裡
逞凶鬥狠=逞凶鬥狠
逞兇鬥狠=逞凶鬥狠
逞凶斗狠=逞凶鬥狠
即食麵=速食麵
方便面=速食麵
快速面=速食麵
连字号=連字號
进制=進位
入球=進球
算子=運算元
遠程控制=遠程控制
远程控制=遠程控制
溫納圖萬=那杜
醫院裏=醫院裡
酰=醯
钩=鉤
鈎=鉤
钩心斗角=鉤心鬥角
鈎心鬥角=鉤心鬥角
锎=鉲
写保护=防寫
阿拉伯联合酋长国=阿拉伯聯合大公國
阿拉伯聯合酋長國=阿拉伯聯合大公國
噪声=雜訊
脱机=離線
雪裏紅=雪裡紅
雪裏蕻=雪裡蕻
雪铁龙=雪鐵龍
青霉素=青黴素
异步=非同步
声卡=音效卡
缺省=預設
颁布=頒布
頒佈=頒布
領域裏=領域裡
头球=頭槌
粒入球=顆進球
館裏=館裡
马里共和国=馬利共和國
馬里共和國=馬利共和國
马耳他=馬爾他
马尔代夫=馬爾地夫
馬爾代夫=馬爾地夫
萬事得=馬自達
狄安娜=黛安娜
戴安娜=黛安娜
點裏=點裡
位图=點陣圖
);

$zh2HK = array(
“=「
”=」
‘=『
’=』
三極體=三極管
不著痕跡=不着痕跡
不著邊際=不着邊際
世界裡=世界裏
世界里=世界裏
中文里=中文裏
中文裡=中文裏
民乐=中樂
华乐=中樂
查德=乍得
乘著=乘着
乘著作=乘著作
乘著名=乘著名
乘著書=乘著書
乘著稱=乘著稱
乘著者=乘著者
乘著述=乘著述
乘著錄=乘著錄
葉門=也門
二極體=二極管
網際網路=互聯網
因特网=互聯網
亮著=亮着
亮著作=亮著作
亮著名=亮著名
亮著書=亮著書
亮著稱=亮著稱
亮著者=亮著者
亮著述=亮著述
亮著錄=亮著錄
人工智慧=人工智能
仗著=仗着
仗著作=仗著作
仗著名=仗著名
仗著書=仗著書
仗著稱=仗著稱
仗著者=仗著者
仗著述=仗著述
仗著錄=仗著錄
代表著=代表着
代表著作=代表著作
代表著名=代表著名
代表著書=代表著書
代表著稱=代表著稱
代表著者=代表著者
代表著述=代表著述
代表著錄=代表著錄
貝里斯=伯利茲
伴著=伴着
伴著作=伴著作
伴著名=伴著名
伴著書=伴著書
伴著稱=伴著稱
伴著者=伴著者
伴著述=伴著述
伴著錄=伴著錄
字節=位元組
字节=位元組
低著=低着
低著作=低著作
低著名=低著名
低著書=低著書
低著稱=低著稱
低著者=低著者
低著述=低著述
低著錄=低著錄
住著=住着
住著作=住著作
住著名=住著名
住著書=住著書
住著稱=住著稱
住著者=住著者
住著述=住著述
住著錄=住著錄
維德角=佛得角
作品裡=作品裏
作品里=作品裏
來著=來着
來著作=來著作
來著名=來著名
來著書=來著書
來著稱=來著稱
來著者=來著者
來著述=來著述
來著錄=來著錄
海珊=侯賽因
保障著=保障着
保障著作=保障著作
保障著名=保障著名
保障著書=保障著書
保障著稱=保障著稱
保障著者=保障著者
保障著述=保障著述
保障著錄=保障著錄
信著=信着
信著作=信著作
信著名=信著名
信著書=信著書
信著稱=信著稱
信著者=信著者
信著述=信著述
信著錄=信著錄
候著=候着
候著作=候著作
候著名=候著名
候著書=候著書
候著稱=候著稱
候著者=候著者
候著述=候著述
候著錄=候著錄
借著=借着
借著作=借著作
借著名=借著名
借著書=借著書
借著稱=借著稱
借著者=借著者
借著述=借著述
借著錄=借著錄
做著=做着
做著作=做著作
做著名=做著名
做著書=做著書
做著稱=做著稱
做著者=做著者
做著述=做著述
做著錄=做著錄
側著=側着
側著作=側著作
側著名=側著名
側著書=側著書
側著稱=側著稱
側著者=側著者
側著述=側著述
側著錄=側著錄
偷著=偷着
偷著作=偷著作
偷著名=偷著名
偷著書=偷著書
偷著稱=偷著稱
偷著者=偷著者
偷著述=偷著述
偷著錄=偷著錄
備著=備着
備著作=備著作
備著名=備著名
備著書=備著書
備著稱=備著稱
備著者=備著者
備著述=備著述
備著錄=備著錄
凶殘=兇殘
凶殺=兇殺
雪铁龙=先進
雪鐵龍=先進
光著=光着
光著作=光著作
光著名=光著名
光著書=光著書
光著稱=光著稱
光著者=光著者
光著述=光著述
光著錄=光著錄
柯林頓=克林頓
克羅埃西亞=克羅地亞
公車上書=公車上書
冀著=冀着
冀著作=冀著作
冀著名=冀著名
冀著書=冀著書
冀著稱=冀著稱
冀著者=冀著者
冀著述=冀著述
冀著錄=冀著錄
冒著=冒着
冒著作=冒著作
冒著名=冒著名
冒著書=冒著書
冒著稱=冒著稱
冒著者=冒著者
冒著述=冒著述
冒著錄=冒著錄
冬天里=冬天裏
冬天裡=冬天裏
冬日裡=冬日裏
冬日里=冬日裏
分布=分佈
分布於=分佈於
分布于=分佈於
列支敦斯登=列支敦士登
賴比瑞亞=利比里亞
制著=制着
制著作=制著作
制著名=制著名
制著書=制著書
制著稱=制著稱
制著者=制著者
制著述=制著述
制著錄=制著錄
刻著=刻着
刻著作=刻著作
刻著名=刻著名
刻著書=刻著書
刻著稱=刻著稱
刻著者=刻著者
刻著述=刻著述
刻著錄=刻著錄
迦納=加納
加彭=加蓬
努力著=努力着
努力著作=努力著作
努力著名=努力著名
努力著書=努力著書
努力著稱=努力著稱
努力著者=努力著者
努力著述=努力著述
努力著錄=努力著錄
努著=努着
努著作=努著作
努著名=努著名
努著書=努著書
努著稱=努著稱
努著者=努著者
努著述=努著述
努著錄=努著錄
動著=動着
動著作=動著作
動著名=動著名
動著書=動著書
動著稱=動著稱
動著者=動著者
動著述=動著述
動著錄=動著錄
医院里=医院裏
波札那=博茨瓦納
珍妮弗·卡普里亚蒂=卡佩雅蒂
印著=印着
印著作=印著作
印著名=印著名
印著書=印著書
印著稱=印著稱
印著者=印著者
印著述=印著述
印著錄=印著錄
瓜地馬拉=危地馬拉
泡麵=即食麵
方便面=即食麵
快速面=即食麵
速食麵=即食麵
厄瓜多=厄瓜多爾
厄瓜多爾=厄瓜多爾
厄瓜多尔=厄瓜多爾
厄利垂亞=厄立特里亞
去著=去着
去著作=去著作
去著名=去著名
去著書=去著書
去著稱=去著稱
去著者=去著者
去著述=去著述
去著錄=去著錄
受著=受着
受著作=受著作
受著名=受著名
受著書=受著書
受著稱=受著稱
受著者=受著者
受著述=受著述
受著錄=受著錄
叫著=叫着
叫著作=叫著作
叫著名=叫著名
叫著書=叫著書
叫著稱=叫著稱
叫著者=叫著者
叫著述=叫著述
叫著錄=叫著錄
叱吒=叱咤
叱咤=叱咤
吃不著=吃不着
吃得著=吃得着
吃著=吃着
吉布地=吉布堤
向著=向着
向著作=向著作
向著名=向著名
向著書=向著書
向著稱=向著稱
向著者=向著者
向著述=向著述
向著錄=向著錄
含著=含着
含著作=含著作
含著名=含著名
含著書=含著書
含著稱=含著稱
含著者=含著者
含著述=含著述
含著錄=含著錄
吹著=吹着
吹著作=吹著作
吹著名=吹著名
吹著書=吹著書
吹著稱=吹著稱
吹著者=吹著者
吹著述=吹著述
吹著錄=吹著錄
味著=味着
味著作=味著作
味著名=味著名
味著書=味著書
味著稱=味著稱
味著者=味著者
味著述=味著述
味著錄=味著錄
咤=咤
哥斯大黎加=哥斯達黎加
哭著=哭着
哭著作=哭著作
哭著名=哭著名
哭著書=哭著書
哭著稱=哭著稱
哭著者=哭著者
哭著述=哭著述
哭著錄=哭著錄
唱著=唱着
唱著作=唱著作
唱著名=唱著名
唱著書=唱著書
唱著稱=唱著稱
唱著者=唱著者
唱著述=唱著述
唱著錄=唱著錄
喝著=喝着
喝著作=喝著作
喝著名=喝著名
喝著書=喝著書
喝著稱=喝著稱
喝著者=喝著者
喝著述=喝著述
喝著錄=喝著錄
自行车=單車
嗅不著=嗅不着
嗅得著=嗅得着
嗅著=嗅着
嘴里=嘴裏
嘴裡=嘴裏
嚷著=嚷着
嚷著作=嚷著作
嚷著名=嚷著名
嚷著書=嚷著書
嚷著稱=嚷著稱
嚷著者=嚷著者
嚷著述=嚷著述
嚷著錄=嚷著錄
因著=因着
因著作=因著作
因著名=因著名
因著書=因著書
因著稱=因著稱
因著者=因著者
因著述=因著述
因著錄=因著錄
困著=困着
困著作=困著作
困著名=困著名
困著書=困著書
困著稱=困著稱
困著者=困著者
困著述=困著述
困著錄=困著錄
圍著=圍着
圍著作=圍著作
圍著名=圍著名
圍著書=圍著書
圍著稱=圍著稱
圍著者=圍著者
圍著述=圍著述
圍著錄=圍著錄
吐瓦魯=圖瓦盧
土豆網=土豆網
土豆网=土豆網
在著=在着
在著作=在著作
在著名=在著名
在著書=在著書
在著稱=在著稱
在著者=在著者
在著述=在著述
在著錄=在著錄
蓋亞那=圭亞那
坐著=坐着
坐著作=坐著作
坐著名=坐著名
坐著書=坐著書
坐著稱=坐著稱
坐著者=坐著者
坐著述=坐著述
坐著錄=坐著錄
坦尚尼亞=坦桑尼亞
衣索匹亞=埃塞俄比亞
衣索比亞=埃塞俄比亞
吉里巴斯=基里巴斯
塞普勒斯=塞浦路斯
塞席爾=塞舌爾
壓著=壓着
壓著作=壓著作
壓著名=壓著名
壓著書=壓著書
壓著稱=壓著稱
壓著者=壓著者
壓著述=壓著述
壓著錄=壓著錄
夏天里=夏天裏
夏天裡=夏天裏
夏日里=夏日裏
夏日裡=夏日裏
夢著=夢着
夢著作=夢著作
夢著名=夢著名
夢著書=夢著書
夢著稱=夢著稱
夢著者=夢著者
夢著述=夢著述
夢著錄=夢著錄
大卫·贝克汉姆=大衛碧咸
夾著=夾着
夾著作=夾著作
夾著名=夾著名
夾著書=夾著書
夾著稱=夾著稱
夾著者=夾著者
夾著述=夾著述
夾著錄=夾著錄
孤著=孤着
孤著作=孤著作
孤著名=孤著名
孤著書=孤著書
孤著稱=孤著稱
孤著者=孤著者
孤著述=孤著述
孤著錄=孤著錄
學著=學着
學著作=學著作
學著名=學著名
學著書=學著書
學著稱=學著稱
學著者=學著者
學著述=學著述
學著錄=學著錄
學裡=學裏
学里=學裏
守著=守着
守著作=守著作
守著名=守著名
守著書=守著書
守著稱=守著稱
守著者=守著者
守著述=守著述
守著錄=守著錄
安地卡及巴布達=安提瓜和巴布達
定著=定着
定著作=定著作
定著名=定著名
定著書=定著書
定著稱=定著稱
定著者=定著者
定著述=定著述
定著錄=定著錄
沃尓沃=富豪
寒假裡=寒假裏
寒假里=寒假裏
寫著=寫着
寫著作=寫著作
寫著名=寫著名
寫著書=寫著書
寫著稱=寫著稱
寫著者=寫著者
寫著述=寫著述
寫著錄=寫著錄
专辑里=專輯裏
專輯裡=專輯裏
尋著=尋着
尋著作=尋著作
尋著名=尋著名
尋著書=尋著書
尋著稱=尋著稱
尋著者=尋著者
尋著述=尋著述
尋著錄=尋著錄
對著=對着
對著作=對著作
對著名=對著名
對著書=對著書
對著稱=對著稱
對著者=對著者
對著述=對著述
對著錄=對著錄
奈及利亞=尼日利亞
尼日利亚=尼日利亞
尼日利亞=尼日利亞
尼日尔=尼日爾
尼日爾=尼日爾
尼日=尼日爾
展著=展着
展著作=展著作
展著名=展著名
展著書=展著書
展著稱=展著稱
展著者=展著者
展著述=展著述
展著錄=展著錄
山洞裡=山洞裏
山洞里=山洞裏
甘比亞=岡比亞
公車=巴士
巴貝多=巴巴多斯
巴布亞紐幾內亞=巴布亞新畿內亞
布吉納法索=布基納法索
布希亞=布希亞
布希亚=布希亞
布希=布殊
布什=布殊
蒲隆地=布隆迪
希特勒=希特拉
帕劳=帛琉
帶著=帶着
帶著作=帶著作
帶著名=帶著名
帶著書=帶著書
帶著稱=帶著稱
帶著者=帶著者
帶著述=帶著述
帶著錄=帶著錄
幫著=幫着
幫著作=幫著作
幫著名=幫著名
幫著書=幫著書
幫著稱=幫著稱
幫著者=幫著者
幫著述=幫著述
幫著錄=幫著錄
干着急=干着急
賓士=平治
年代里=年代裏
年代裡=年代裏
幹著=幹着
干着=幹着
幾內亞比索=幾內亞比紹
康著=康着
康著作=康著作
康著名=康著名
康著書=康著書
康著稱=康著稱
康著者=康著者
康著述=康著述
康著錄=康著錄
待著=待着
待著作=待著作
待著名=待著名
待著書=待著書
待著稱=待著稱
待著者=待著者
待著述=待著述
待著錄=待著錄
得著=得着
得著作=得著作
得著名=得著名
得著書=得著書
得著稱=得著稱
得著者=得著者
得著述=得著述
得著錄=得著錄
循著=循着
循著作=循著作
循著名=循著名
循著書=循著書
循著稱=循著稱
循著者=循著者
循著述=循著述
循著錄=循著錄
心著=心着
心繫著=心繫着
心著作=心著作
心著名=心著名
心著書=心著書
心著稱=心著稱
心著者=心著者
心著述=心著述
心著錄=心著錄
心裡=心裏
心里=心裏
忍著=忍着
忍著作=忍著作
忍著名=忍著名
忍著書=忍著書
忍著稱=忍著稱
忍著者=忍著者
忍著述=忍著述
忍著錄=忍著錄
志著=志着
志著作=志著作
志著名=志著名
志著書=志著書
志著稱=志著稱
志著者=志著者
志著述=志著述
志著錄=志著錄
忙著=忙着
忙著作=忙著作
忙著名=忙著名
忙著書=忙著書
忙著稱=忙著稱
忙著者=忙著者
忙著述=忙著述
忙著錄=忙著錄
急著=急着
急著作=急著作
急著名=急著名
急著書=急著書
急著稱=急著稱
急著者=急著者
急著述=急著述
急著錄=急著錄
性著=性着
性著作=性著作
性著名=性著名
性著書=性著書
性著稱=性著稱
性著者=性著者
性著述=性著述
性著錄=性著錄
悠著=悠着
悠著作=悠著作
悠著名=悠著名
悠著書=悠著書
悠著稱=悠著稱
悠著者=悠著者
悠著述=悠著述
悠著錄=悠著錄
想象=想像
想著=想着
想著作=想著作
想著名=想著名
想著書=想著書
想著稱=想著稱
想著者=想著者
想著述=想著述
想著錄=想著錄
義大利=意大利
愛著=愛着
愛著作=愛著作
愛著名=愛著名
愛著書=愛著書
愛著稱=愛著稱
愛著者=愛著者
愛著述=愛著述
愛著錄=愛著錄
慣著=慣着
慣著作=慣著作
慣著名=慣著名
慣著書=慣著書
慣著稱=慣著稱
慣著者=慣著者
慣著述=慣著述
慣著錄=慣著錄
應著=應着
應著作=應著作
應著名=應著名
應著書=應著書
應著稱=應著稱
應著者=應著者
應著述=應著述
應著錄=應著錄
懷著=懷着
懷著作=懷著作
懷著名=懷著名
懷著書=懷著書
懷著稱=懷著稱
懷著者=懷著者
懷著述=懷著述
懷著錄=懷著錄
戀著=戀着
戀著作=戀著作
戀著名=戀著名
戀著書=戀著書
戀著稱=戀著稱
戀著者=戀著者
戀著述=戀著述
戀著錄=戀著錄
戰著=戰着
戰著作=戰著作
戰著名=戰著名
戰著書=戰著書
戰著稱=戰著稱
戰著者=戰著者
戰著述=戰著述
戰著錄=戰著錄
戲裡=戲裏
戏里=戲裏
黛安娜=戴安娜
狄安娜=戴安娜
戴著=戴着
戴著作=戴著作
戴著名=戴著名
戴著書=戴著書
戴著稱=戴著稱
戴著者=戴著者
戴著述=戴著述
戴著錄=戴著錄
索羅門群島=所羅門群島
列印=打印
印表機=打印機
打著=打着
打著作=打著作
打著名=打著名
打著書=打著書
打著稱=打著稱
打著者=打著者
打著述=打著述
打著錄=打著錄
扛著=扛着
扛著作=扛著作
扛著名=扛著名
扛著書=扛著書
扛著稱=扛著稱
扛著者=扛著者
扛著述=扛著述
扛著錄=扛著錄
找不著=找不着
找得著=找得着
抓著=抓着
抓著作=抓著作
抓著名=抓著名
抓著稱=抓著稱
抓著者=抓著者
抓著述=抓著述
抓著錄=抓著錄
披著=披着
披著作=披著作
披著名=披著名
披著書=披著書
披著稱=披著稱
披著者=披著者
披著述=披著述
披著錄=披著錄
抬著=抬着
抬著作=抬著作
抬著名=抬著名
抬著稱=抬著稱
抬著者=抬著者
抬著述=抬著述
抬著錄=抬著錄
抱著=抱着
抱著作=抱著作
抱著名=抱著名
抱著稱=抱著稱
抱著者=抱著者
抱著述=抱著述
抱著錄=抱著錄
拉著=拉着
拉著作=拉著作
拉著名=拉著名
拉著書=拉著書
拉著稱=拉著稱
拉著者=拉著者
拉著述=拉著述
拉著錄=拉著錄
拎著=拎着
拎著作=拎著作
拎著名=拎著名
拎著稱=拎著稱
拎著者=拎著者
拎著述=拎著述
拎著錄=拎著錄
拖著=拖着
拖著作=拖著作
拖著名=拖著名
拖著稱=拖著稱
拖著者=拖著者
拖著述=拖著述
拖著錄=拖著錄
拼著=拼着
拼著作=拼著作
拼著名=拼著名
拼著稱=拼著稱
拼著者=拼著者
拼著述=拼著述
拼著錄=拼著錄
拿著=拿着
拿著作=拿著作
拿著名=拿著名
拿著稱=拿著稱
拿著者=拿著者
拿著述=拿著述
拿著錄=拿著錄
持著=持着
持著作=持著作
持著名=持著名
持著稱=持著稱
持著者=持著者
持著述=持著述
持著錄=持著錄
挑著=挑着
挑著作=挑著作
挑著名=挑著名
挑著稱=挑著稱
挑著者=挑著者
挑著述=挑著述
挑著錄=挑著錄
挨著=挨着
挨著作=挨著作
挨著名=挨著名
挨著稱=挨著稱
挨著者=挨著者
挨著述=挨著述
挨著錄=挨著錄
捆著=捆着
捆著作=捆著作
捆著名=捆著名
捆著稱=捆著稱
捆著者=捆著者
捆著述=捆著述
捆著錄=捆著錄
掖著=掖着
掖著作=掖著作
掖著名=掖著名
掖著稱=掖著稱
掖著者=掖著者
掖著述=掖著述
掖著錄=掖著錄
掙著=掙着
掙著作=掙著作
掙著名=掙著名
掙著書=掙著書
掙著稱=掙著稱
掙著者=掙著者
掙著述=掙著述
掙著錄=掙著錄
掛鉤=掛鈎
接著=接着
接著作=接著作
接著名=接著名
接著稱=接著稱
接著者=接著者
接著述=接著述
接著錄=接著錄
揉著=揉着
揉著作=揉著作
揉著名=揉著名
揉著書=揉著書
揉著稱=揉著稱
揉著者=揉著者
揉著述=揉著述
揉著錄=揉著錄
提著=提着
提著作=提著作
提著名=提著名
提著稱=提著稱
提著者=提著者
提著述=提著述
提著錄=提著錄
揮著=揮着
揮著作=揮著作
揮著名=揮著名
揮著稱=揮著稱
揮著者=揮著者
揮著述=揮著述
揮著錄=揮著錄
摟著=摟着
摟著作=摟著作
摟著名=摟著名
摟著稱=摟著稱
摟著者=摟著者
摟著述=摟著述
摟著錄=摟著錄
撼著=撼着
撼著作=撼著作
撼著名=撼著名
撼著書=撼著書
撼著稱=撼著稱
撼著者=撼著者
撼著述=撼著述
撼著錄=撼著錄
擋著=擋着
擋著作=擋著作
擋著名=擋著名
擋著稱=擋著稱
擋著者=擋著者
擋著述=擋著述
擋著錄=擋著錄
據著=據着
據著作=據著作
據著名=據著名
據著書=據著書
據著稱=據著稱
據著者=據著者
據著述=據著述
據著錄=據著錄
擺著=擺着
擺著作=擺著作
擺著名=擺著名
擺著稱=擺著稱
擺著者=擺著者
擺著述=擺著述
擺著錄=擺著錄
故事里=故事裏
故事裡=故事裏
敞著=敞着
敞著作=敞著作
敞著名=敞著名
敞著稱=敞著稱
敞著者=敞著者
敞著述=敞著述
敞著錄=敞著錄
數著=數着
數著作=數著作
數著名=數著名
數著稱=數著稱
數著者=數著者
數著述=數著述
數著錄=數著錄
斥著=斥着
斥著作=斥著作
斥著名=斥著名
斥著書=斥著書
斥著稱=斥著稱
斥著者=斥著者
斥著述=斥著述
斥著錄=斥著錄
史瓦濟蘭=斯威士蘭
斯洛維尼亞=斯洛文尼亞
新著龍虎門=新著龍虎門
紐西蘭=新西蘭
日子里=日子裏
日子裡=日子裏
昂著=昂着
昂著作=昂著作
昂著名=昂著名
昂著書=昂著書
昂著稱=昂著稱
昂著者=昂著者
昂著述=昂著述
昂著錄=昂著錄
映著=映着
映著作=映著作
映著名=映著名
映著書=映著書
映著稱=映著稱
映著者=映著者
映著述=映著述
映著錄=映著錄
春假里=春假裏
春假裡=春假裏
春天裡=春天裏
春天里=春天裏
春日裡=春日裏
春日里=春日裏
时间里=時間裏
時間裡=時間裏
晃著=晃着
晃著作=晃著作
晃著名=晃著名
晃著稱=晃著稱
晃著者=晃著者
晃著述=晃著述
晃著錄=晃著錄
暑假里=暑假裏
暑假裡=暑假裏
暗著=暗着
暗著作=暗著作
暗著名=暗著名
暗著書=暗著書
暗著稱=暗著稱
暗著者=暗著者
暗著述=暗著述
暗著錄=暗著錄
有著=有着
有著作=有著作
有著名=有著名
有著書=有著書
有著稱=有著稱
有著者=有著者
有著述=有著述
有著錄=有著錄
望著=望着
望著作=望著作
望著名=望著名
望著書=望著書
望著稱=望著稱
望著者=望著者
望著述=望著述
望著錄=望著錄
朝著=朝着
朝著作=朝著作
朝著名=朝著名
朝著稱=朝著稱
朝著者=朝著者
朝著述=朝著述
朝著錄=朝著錄
本著=本着
本著作=本著作
本著名=本著名
本著書=本著書
本著稱=本著稱
本著者=本著者
本著述=本著述
本著錄=本著錄
村子里=村子裏
村子裡=村子裏
枕著=枕着
枕著作=枕著作
枕著名=枕著名
枕著稱=枕著稱
枕著者=枕著者
枕著述=枕著述
枕著錄=枕著錄
格瑞那達=格林納達
撞球=桌球
台球=桌球
梳著=梳着
梳著作=梳著作
梳著名=梳著名
梳著稱=梳著稱
梳著者=梳著者
梳著述=梳著述
梳著錄=梳著錄
森林裡=森林裏
森林里=森林裏
棺材裡=棺材裏
棺材里=棺材裏
榴蓮=榴槤
榴莲=榴槤
樂著=樂着
樂著作=樂著作
樂著名=樂著名
樂著書=樂著書
樂著稱=樂著稱
樂著者=樂著者
樂著述=樂著述
樂著錄=樂著錄
寶獅=標致
標誌著=標誌着
機器人=機械人
机器人=機械人
历史里=歷史裏
歷史裡=歷史裏
殺著=殺着
殺著作=殺著作
殺著名=殺著名
殺著書=殺著書
殺著稱=殺著稱
殺著者=殺著者
殺著述=殺著述
殺著錄=殺著錄
茅利塔尼亞=毛里塔尼亞
毛里求斯=毛里裘斯
模里西斯=毛里裘斯
求著=求着
求著作=求著作
求著名=求著名
求著書=求著書
求著稱=求著稱
求著者=求著者
求著述=求著述
求著錄=求著錄
文莱=汶萊
沉著=沉着
沉著作=沉著作
沉著名=沉著名
沉著書=沉著書
沉著稱=沉著稱
沉著者=沉著者
沉著述=沉著述
沉著錄=沉著錄
沙地阿拉伯=沙特阿拉伯
沙烏地阿拉伯=沙特阿拉伯
马拉特·萨芬=沙芬
沿著=沿着
沿著作=沿著作
沿著名=沿著名
沿著書=沿著書
沿著稱=沿著稱
沿著者=沿著者
沿著述=沿著述
沿著錄=沿著錄
波士尼亞赫塞哥維納=波斯尼亞黑塞哥維那
辛巴威=津巴布韋
宏都拉斯=洪都拉斯
活著=活着
活著作=活著作
活著名=活著名
活著書=活著書
活著稱=活著稱
活著者=活著者
活著述=活著述
活著錄=活著錄
行動電話=流動電話
移动电话=流動電話
流著=流着
流著作=流著作
流著名=流著名
流著書=流著書
流著稱=流著稱
流著者=流著者
流著述=流著述
流著錄=流著錄
流露著=流露着
浮著=浮着
浮著作=浮著作
浮著名=浮著名
浮著書=浮著書
浮著稱=浮著稱
浮著者=浮著者
浮著述=浮著述
浮著錄=浮著錄
涵著=涵着
涵著作=涵著作
涵著名=涵著名
涵著書=涵著書
涵著稱=涵著稱
涵著者=涵著者
涵著述=涵著述
涵著錄=涵著錄
涼著=涼着
涼著作=涼著作
涼著名=涼著名
涼著書=涼著書
涼著稱=涼著稱
涼著者=涼著者
涼著述=涼著述
涼著錄=涼著錄
深淵裡=深淵裏
深渊里=深渊裏
渴著=渴着
渴著作=渴著作
渴著名=渴著名
渴著書=渴著書
渴著稱=渴著稱
渴著者=渴著者
渴著述=渴著述
渴著錄=渴著錄
溢著=溢着
溢著作=溢著作
溢著名=溢著名
溢著書=溢著書
溢著稱=溢著稱
溢著者=溢著者
溢著述=溢著述
溢著錄=溢著錄
演著=演着
演著作=演著作
演著名=演著名
演著書=演著書
演著稱=演著稱
演著者=演著者
演著述=演著述
演著錄=演著錄
漫著=漫着
漫著作=漫著作
漫著名=漫著名
漫著書=漫著書
漫著稱=漫著稱
漫著者=漫著者
漫著述=漫著述
漫著錄=漫著錄
潤著=潤着
潤著作=潤著作
潤著名=潤著名
潤著書=潤著書
潤著稱=潤著稱
潤著者=潤著者
潤著述=潤著述
潤著錄=潤著錄
菸=煙
照著=照着
照著作=照著作
照著名=照著名
照著書=照著書
照著稱=照著稱
照著者=照著者
照著述=照著述
照著錄=照著錄
燒著=燒着
燒著作=燒著作
燒著名=燒著名
燒著書=燒著書
燒著稱=燒著稱
燒著者=燒著者
燒著述=燒著述
燒著錄=燒著錄
爭著=爭着
爭著作=爭著作
爭著名=爭著名
爭著書=爭著書
爭著稱=爭著稱
爭著者=爭著者
爭著述=爭著述
爭著錄=爭著錄
千里達托貝哥=特立尼達和多巴哥
牽著=牽着
牽著作=牽著作
牽著名=牽著名
牽著書=牽著書
牽著稱=牽著稱
牽著者=牽著者
牽著述=牽著述
牽著錄=牽著錄
犯不著=犯不着
犯不著作=犯不著作
犯不著名=犯不著名
犯不著書=犯不著書
犯不著稱=犯不著稱
犯不著者=犯不著者
犯不著述=犯不著述
犯不著錄=犯不著錄
犯得著=犯得着
犬只=狗隻
猜著=猜着
猜著作=猜著作
猜著名=猜著名
猜著書=猜著書
猜著稱=猜著稱
猜著者=猜著者
猜著述=猜著述
猜著錄=猜著錄
狱里=獄裏
獄裡=獄裏
獨著=獨着
獨著作=獨著作
獨著名=獨著名
獨著書=獨著書
獨著稱=獨著稱
獨著者=獨著者
獨著述=獨著述
獨著錄=獨著錄
獲著=獲着
獲著作=獲著作
獲著名=獲著名
獲著書=獲著書
獲著稱=獲著稱
獲著者=獲著者
獲著述=獲著述
獲著錄=獲著錄
諾魯=瑙魯
萬那杜=瓦努阿圖
甜著=甜着
甜著作=甜著作
甜著名=甜著名
甜著書=甜著書
甜著稱=甜著稱
甜著者=甜著者
甜著述=甜著述
甜著錄=甜著錄
用不著=用不着
用得著=用得着
用著=用着
用著作=用著作
用著名=用著名
用著書=用著書
用著稱=用著稱
用著者=用著者
用著述=用著述
用著錄=用著錄
留著=留着
留著作=留著作
留著名=留著名
留著書=留著書
留著稱=留著稱
留著者=留著者
留著述=留著述
留著錄=留著錄
當著=當着
當著作=當著作
當著名=當著名
當著書=當著書
當著稱=當著稱
當著者=當著者
當著述=當著述
當著錄=當著錄
疑著=疑着
疑著作=疑著作
疑著名=疑著名
疑著書=疑著書
疑著稱=疑著稱
疑著者=疑著者
疑著述=疑著述
疑著錄=疑著錄
发布=發佈
發布=發佈
百科裡=百科裏
百科里=百科裏
計程車=的士
出租车=的士
皮里阳秋=皮裏陽秋
皮裡陽秋=皮裏陽秋
皺著=皺着
皺著作=皺著作
皺著名=皺著名
皺著書=皺著書
皺著稱=皺著稱
皺著者=皺著者
皺著述=皺著述
皺著錄=皺著錄
盛著=盛着
盛著作=盛著作
盛著名=盛著名
盛著書=盛著書
盛著稱=盛著稱
盛著者=盛著者
盛著述=盛著述
盛著錄=盛著錄
盧安達=盧旺達
盯著=盯着
盯著作=盯著作
盯著名=盯著名
盯著書=盯著書
盯著稱=盯著稱
盯著者=盯著者
盯著述=盯著述
盯著錄=盯著錄
盾著=盾着
盾著作=盾著作
盾著名=盾著名
盾著書=盾著書
盾著稱=盾著稱
盾著者=盾著者
盾著述=盾著述
盾著錄=盾著錄
看不著=看不着
看得著=看得着
看著=看着
看著作=看著作
看著名=看著名
看著書=看著書
看著稱=看著稱
看著者=看著者
看著述=看著述
看著錄=看著錄
眼睛裡=眼睛裏
眼睛里=眼睛裏
著什麼急=着什麼急
著他=着他
著你=着你
著力=着力
著地=着地
著墨=着墨
著她=着她
著妳=着妳
著它=着它
著實=着實
著忙=着忙
著急=着急
著想=着想
著意=着意
著我=着我
著手=着手
著數=着數
著法=着法
著涼=着涼
著火=着火
著眼=着眼
著祂=着祂
著筆=着筆
著絲=着絲
著緊=着緊
著腳=着腳
著艦=着艦
著色=着色
著落=着落
著衣=着衣
著裝=着裝
著迷=着迷
著重=着重
著錄=着錄
著陸=着陸
著鞭=着鞭
睡不著=睡不着
睡得著=睡得着
睡著=睡着
睡著作=睡著作
睡著名=睡著名
睡著書=睡著書
睡著稱=睡著稱
睡著者=睡著者
睡著述=睡著述
睡著錄=睡著錄
瞞著=瞞着
瞞著作=瞞著作
瞞著名=瞞著名
瞞著書=瞞著書
瞞著稱=瞞著稱
瞞著者=瞞著者
瞞著述=瞞著述
瞞著錄=瞞著錄
瞪著=瞪着
瞪著作=瞪著作
瞪著名=瞪著名
瞪著書=瞪著書
瞪著稱=瞪著稱
瞪著者=瞪著者
瞪著述=瞪著述
瞪著錄=瞪著錄
簡訊=短訊
短信=短訊
硬件=硬件
硬體=硬件
福斯=福士
福著=福着
福著作=福著作
福著名=福著名
福著書=福著書
福著稱=福著稱
福著者=福著者
福著述=福著述
福著錄=福著錄
秋假裡=秋假裏
秋假里=秋假裏
秋天裡=秋天裏
秋天里=秋天裏
秋日里=秋日裏
秋日裡=秋日裏
葛摩=科摩羅
捷豹=積架
空著=空着
空著作=空著作
空著名=空著名
空著書=空著書
空著稱=空著稱
空著者=空著者
空著述=空著述
空著錄=空著錄
太空梭=穿梭機
航天飞机=穿梭機
穿著=穿着
穿著作=穿著作
穿著名=穿著名
穿著書=穿著書
穿著稱=穿著稱
穿著者=穿著者
穿著述=穿著述
穿著錄=穿著錄
站著=站着
站著作=站著作
站著名=站著名
站著書=站著書
站著稱=站著稱
站著者=站著者
站著述=站著述
站著錄=站著錄
笑著=笑着
笑著作=笑著作
笑著名=笑著名
笑著書=笑著書
笑著稱=笑著稱
笑著者=笑著者
笑著述=笑著述
笑著錄=笑著錄
管著=管着
管著作=管著作
管著名=管著名
管著書=管著書
管著稱=管著稱
管著者=管著者
管著述=管著述
管著錄=管著錄
迈克尔·欧文=米高奧雲
系列裡=系列裏
系列里=系列裏
索馬利亞=索馬里
紮著=紮着
紮著作=紮著作
紮著名=紮著名
紮著書=紮著書
紮著稱=紮著稱
紮著者=紮著者
紮著述=紮著述
紮著錄=紮著錄
綁著=綁着
綁著作=綁著作
綁著名=綁著名
綁著書=綁著書
綁著稱=綁著稱
綁著者=綁著者
綁著述=綁著述
綁著錄=綁著錄
網路=網絡
緝凶=緝兇
繞著=繞着
繞著作=繞著作
繞著名=繞著名
繞著書=繞著書
繞著稱=繞著稱
繞著者=繞著者
繞著述=繞著述
繞著錄=繞著錄
纏著=纏着
纏著作=纏著作
纏著名=纏著名
纏著書=纏著書
纏著稱=纏著稱
纏著者=纏著者
纏著述=纏著述
纏著錄=纏著錄
罩著=罩着
罩著作=罩著作
罩著名=罩著名
罩著書=罩著書
罩著稱=罩著稱
罩著者=罩著者
罩著述=罩著述
罩著錄=罩著錄
罵著=罵着
罵著作=罵著作
罵著名=罵著名
罵著書=罵著書
罵著稱=罵著稱
罵著者=罵著者
罵著述=罵著述
罵著錄=罵著錄
美著=美着
美著作=美著作
美著名=美著名
美著書=美著書
美著稱=美著稱
美著者=美著者
美著述=美著述
美著錄=美著錄
耀著=耀着
耀著作=耀著作
耀著名=耀著名
耀著書=耀著書
耀著稱=耀著稱
耀著者=耀著者
耀著述=耀著述
耀著錄=耀著錄
寮國=老撾
考著=考着
考著作=考著作
考著名=考著名
考著書=考著書
考著稱=考著稱
考著者=考著者
考著述=考著述
考著錄=考著錄
圣基茨和尼维斯=聖吉斯納域斯
聖克里斯多福及尼維斯=聖吉斯納域斯
聖文森及格瑞那丁=聖文森特和格林納丁斯
聖露西亞=聖盧西亞
聖馬利諾=聖馬力諾
聽不著=聽不着
聽得著=聽得着
聽著=聽着
聽著作=聽著作
聽著名=聽著名
聽著書=聽著書
聽著稱=聽著稱
聽著者=聽著者
聽著述=聽著述
聽著錄=聽著錄
肚里=肚裏
肚裡=肚裏
肯尼亚=肯雅
肯亞=肯雅
背著=背着
背著作=背著作
背著名=背著名
背著書=背著書
背著稱=背著稱
背著者=背著者
背著述=背著述
背著錄=背著錄
膠著=膠着
膠著作=膠著作
膠著名=膠著名
膠著書=膠著書
膠著稱=膠著稱
膠著者=膠著者
膠著述=膠著述
膠著錄=膠著錄
臨著=臨着
臨著作=臨著作
臨著名=臨著名
臨著書=臨著書
臨著稱=臨著稱
臨著者=臨著者
臨著述=臨著述
臨著錄=臨著錄
與著=與着
與著作=與著作
與著名=與著名
與著書=與著書
與著稱=與著稱
與著者=與著者
與著述=與著述
與著錄=與著錄
迈克尔·舒马赫=舒麥加
苦著=苦着
苦著作=苦著作
苦著名=苦著名
苦著書=苦著書
苦著稱=苦著稱
苦著者=苦著者
苦著述=苦著述
苦著錄=苦著錄
苦里=苦裏
苦裡=苦裏
莫三比克=莫桑比克
賴索托=萊索托
馬自達=萬事得
马自达=萬事得
落著=落着
落著作=落著作
落著名=落著名
落著書=落著書
落著稱=落著稱
落著者=落著者
落著述=落著述
落著錄=落著錄
蒙著=蒙着
蒙著作=蒙著作
蒙著名=蒙著名
蒙著書=蒙著書
蒙著稱=蒙著稱
蒙著者=蒙著者
蒙著述=蒙著述
蒙著錄=蒙著錄
萨达姆=薩達姆
藉著=藉着
藏著=藏着
藏著作=藏著作
藏著名=藏著名
藏著書=藏著書
藏著稱=藏著稱
藏著者=藏著者
藏著述=藏著述
藏著錄=藏著錄
藝著=藝着
藝著作=藝著作
藝著名=藝著名
藝著書=藝著書
藝著稱=藝著稱
藝著者=藝著者
藝著述=藝著述
藝著錄=藝著錄
蘸著=蘸着
蘸著作=蘸著作
蘸著名=蘸著名
蘸著書=蘸著書
蘸著稱=蘸著稱
蘸著者=蘸著者
蘸著述=蘸著述
蘸著錄=蘸著錄
行著=行着
行著作=行著作
行著名=行著名
行著書=行著書
行著稱=行著稱
行著者=行著者
行著述=行著述
行著錄=行著錄
衛=衞
衣著=衣着
衣著作=衣著作
衣著名=衣著名
衣著書=衣著書
衣著稱=衣著稱
衣著者=衣著者
衣著述=衣著述
衣著錄=衣著錄
裡勾外連=裏勾外連
里勾外连=裏勾外連
里面=裏面
裡面=裏面
裝著=裝着
裝著作=裝著作
裝著名=裝著名
裝著書=裝著書
裝著稱=裝著稱
裝著者=裝著者
裝著述=裝著述
裝著錄=裝著錄
裹著=裹着
裹著作=裹著作
裹著名=裹著名
裹著書=裹著書
裹著稱=裹著稱
裹著者=裹著者
裹著述=裹著述
裹著錄=裹著錄
見著=見着
見著作=見著作
見著名=見著名
見著書=見著書
見著稱=見著稱
見著者=見著者
見著述=見著述
見著錄=見著錄
記著=記着
記著作=記著作
記著名=記著名
記著書=記著書
記著稱=記著稱
記著者=記著者
記著述=記著述
記著錄=記著錄
試著=試着
試著作=試著作
試著名=試著名
試著書=試著書
試著稱=試著稱
試著者=試著者
試著述=試著述
試著錄=試著錄
語著=語着
語著作=語著作
語著名=語著名
語著書=語著書
語著稱=語著稱
語著者=語著者
語著述=語著述
語著錄=語著錄
數據機=調制解調器
警戒著=警戒着
變著=變着
變著作=變著作
變著名=變著名
變著書=變著書
變著稱=變著稱
變著者=變著者
變著述=變著述
變著錄=變著錄
豎著=豎着
豎著作=豎著作
豎著名=豎著名
豎著書=豎著書
豎著稱=豎著稱
豎著者=豎著者
豎著述=豎著述
豎著錄=豎著錄
豫著=豫着
豫著作=豫著作
豫著名=豫著名
豫著書=豫著書
豫著稱=豫著稱
豫著者=豫著者
豫著述=豫著述
豫著錄=豫著錄
貝南=貝寧
貞著=貞着
貞著作=貞著作
貞著名=貞著名
貞著書=貞著書
貞著稱=貞著稱
貞著者=貞著者
貞著述=貞著述
貞著錄=貞著錄
買凶=買兇
尚比亞=贊比亞
走著=走着
走著作=走著作
走著名=走著名
走著書=走著書
走著稱=走著稱
走著者=走著者
走著述=走著述
走著錄=走著錄
趕著=趕着
趕著作=趕著作
趕著名=趕著名
趕著書=趕著書
趕著稱=趕著稱
趕著者=趕著者
趕著述=趕著述
趕著錄=趕著錄
趴著=趴着
趴著作=趴著作
趴著名=趴著名
趴著書=趴著書
趴著稱=趴著稱
趴著者=趴著者
趴著述=趴著述
趴著錄=趴著錄
跑著=跑着
跑著作=跑著作
跑著名=跑著名
跑著書=跑著書
跑著稱=跑著稱
跑著者=跑著者
跑著述=跑著述
跑著錄=跑著錄
跟著=跟着
跟著作=跟著作
跟著名=跟著名
跟著書=跟著書
跟著稱=跟著稱
跟著者=跟著者
跟著述=跟著述
跟著錄=跟著錄
跪著=跪着
跪著作=跪著作
跪著名=跪著名
跪著書=跪著書
跪著稱=跪著稱
跪著者=跪著者
跪著述=跪著述
跪著錄=跪著錄
跳著=跳着
跳著作=跳著作
跳著名=跳著名
跳著書=跳著書
跳著稱=跳著稱
跳著者=跳著者
跳著述=跳著述
跳著錄=跳著錄
踏著=踏着
踏著作=踏著作
踏著名=踏著名
踏著稱=踏著稱
踏著者=踏著者
踏著述=踏著述
踏著錄=踏著錄
踩著=踩着
踩著作=踩著作
踩著名=踩著名
踩著書=踩著書
踩著稱=踩著稱
踩著者=踩著者
踩著述=踩著述
踩著錄=踩著錄
躍著=躍着
躍著作=躍著作
躍著名=躍著名
躍著書=躍著書
躍著稱=躍著稱
躍著者=躍著者
躍著述=躍著述
躍著錄=躍著錄
身著=身着
身著作=身著作
身著名=身著名
身著書=身著書
身著稱=身著稱
身著者=身著者
身著述=身著述
身著錄=身著錄
躺著=躺着
躺著作=躺著作
躺著名=躺著名
躺著書=躺著書
躺著稱=躺著稱
躺著者=躺著者
躺著述=躺著述
躺著錄=躺著錄
軟體=軟件
載著=載着
載著作=載著作
載著名=載著名
載著書=載著書
載著稱=載著稱
載著者=載著者
載著述=載著述
載著錄=載著錄
轉著=轉着
轉著作=轉著作
轉著名=轉著名
轉著書=轉著書
轉著稱=轉著稱
轉著者=轉著者
轉著述=轉著述
轉著錄=轉著錄
辦著=辦着
辦著作=辦著作
辦著名=辦著名
辦著書=辦著書
辦著稱=辦著稱
辦著者=辦著者
辦著述=辦著述
辦著錄=辦著錄
近角聪信=近角聰信
近角聰信=近角聰信
迫著=迫着
追著=追着
追著作=追著作
追著名=追著名
追著書=追著書
追著稱=追著稱
追著者=追著者
追著述=追著述
追著錄=追著錄
逆著=逆着
逆著作=逆著作
逆著名=逆著名
逆著書=逆著書
逆著稱=逆著稱
逆著者=逆著者
逆著述=逆著述
逆著錄=逆著錄
這里=這裏
這裡=這裏
連著=連着
連著作=連著作
連著名=連著名
連著書=連著書
連著稱=連著稱
連著者=連著者
連著述=連著述
連著錄=連著錄
逼著=逼着
逼著作=逼著作
逼著名=逼著名
逼著書=逼著書
逼著稱=逼著稱
逼著者=逼著者
逼著述=逼著述
逼著錄=逼著錄
遇著=遇着
遇著作=遇著作
遇著名=遇著名
遇著書=遇著書
遇著稱=遇著稱
遇著者=遇著者
遇著述=遇著述
遇著錄=遇著錄
達著=達着
達著作=達著作
達著名=達著名
達著書=達著書
達著稱=達著稱
達著者=達著者
達著述=達著述
達著錄=達著錄
遠著=遠着
遠著作=遠著作
遠著名=遠著名
遠著書=遠著書
遠著稱=遠著稱
遠著者=遠著者
遠著述=遠著述
遠著錄=遠著錄
配著=配着
配著作=配著作
配著名=配著名
配著書=配著書
配著稱=配著稱
配著者=配著者
配著述=配著述
配著錄=配著錄
醯=酰
醜著=醜着
醜著作=醜著作
醜著名=醜著名
醜著書=醜著書
醜著稱=醜著稱
醜著者=醜著者
醜著述=醜著述
醜著錄=醜著錄
醫院裡=醫院裏
醯壺=醯壺
醯壶=醯壺
醯醋=醯醋
醯醢=醯醢
醯醬=醯醬
醯酱=醯醬
醯鸡=醯雞
醯雞=醯雞
釀著=釀着
釀著作=釀著作
釀著名=釀著名
釀著書=釀著書
釀著稱=釀著稱
釀著者=釀著者
釀著述=釀著述
釀著錄=釀著錄
鉤=鈎
鉤心鬥角=鈎心鬥角
鋪著=鋪着
鋪著作=鋪著作
鋪著名=鋪著名
鋪著書=鋪著書
鋪著稱=鋪著稱
鋪著者=鋪著者
鋪著述=鋪著述
鋪著錄=鋪著錄
閉著=閉着
閉著作=閉著作
閉著名=閉著名
閉著書=閉著書
閉著稱=閉著稱
閉著者=閉著者
閉著述=閉著述
閉著錄=閉著錄
開著=開着
開著作=開著作
開著名=開著名
開著書=開著書
開著稱=開著稱
開著者=開著者
開著述=開著述
開著錄=開著錄
閑著=閑着
閑著作=閑著作
閑著名=閑著名
閑著書=閑著書
閑著稱=閑著稱
閑著者=閑著者
閑著述=閑著述
閑著錄=閑著錄
關著=關着
關著作=關著作
關著名=關著名
關著書=關著書
關著稱=關著稱
關著者=關著者
關著述=關著述
關著錄=關著錄
聞不著=闻不着
聞得著=闻得着
聞著=闻着
亞塞拜然=阿塞拜疆
阿拉伯聯合大公國=阿拉伯聯合酋長國
附著=附着
附著作=附著作
附著名=附著名
附著書=附著書
附著稱=附著稱
附著者=附著者
附著述=附著述
附著錄=附著錄
陋著=陋着
陋著作=陋著作
陋著名=陋著名
陋著書=陋著書
陋著稱=陋著稱
陋著者=陋著者
陋著述=陋著述
陋著錄=陋著錄
陪著=陪着
陪著作=陪著作
陪著名=陪著名
陪著書=陪著書
陪著稱=陪著稱
陪著者=陪著者
陪著述=陪著述
陪著錄=陪著錄
隔著=隔着
隔著作=隔著作
隔著名=隔著名
隔著書=隔著書
隔著稱=隔著稱
隔著者=隔著者
隔著述=隔著述
隔著錄=隔著錄
隨著=隨着
隨著作=隨著作
隨著名=隨著名
隨著書=隨著書
隨著稱=隨著稱
隨著者=隨著者
隨著述=隨著述
隨著錄=隨著錄
雅著=雅着
雅著作=雅著作
雅著名=雅著名
雅著書=雅著書
雅著稱=雅著稱
雅著者=雅著者
雅著述=雅著述
雅著錄=雅著錄
雜著=雜着
雜著作=雜著作
雜著名=雜著名
雜著書=雜著書
雜著稱=雜著稱
雜著者=雜著者
雜著述=雜著述
雜著錄=雜著錄
冰淇淋=雪糕
雪里红=雪裏紅
雪裡紅=雪裏紅
雪裡蕻=雪裏蕻
雪里蕻=雪裏蕻
靠著=靠着
靠著作=靠著作
靠著名=靠著名
靠著稱=靠著稱
靠著称=靠著稱
靠著者=靠著者
靠著述=靠著述
靠著錄=靠著錄
靠著录=靠著錄
響著=響着
響著作=響著作
響著名=響著名
響著書=響著書
響著稱=響著稱
響著者=響著者
響著述=響著述
響著錄=響著錄
頂著=頂着
頂著作=頂著作
頂著名=頂著名
頂著書=頂著書
頂著稱=頂著稱
頂著者=頂著者
頂著述=頂著述
頂著錄=頂著錄
順著=順着
順著作=順著作
順著名=順著名
順著書=順著書
順著稱=順著稱
順著者=順著者
順著述=順著述
順著錄=順著錄
頒布=頒佈
颁布=頒佈
領域裡=領域裏
领域里=領域裏
領著=領着
領著作=領著作
領著名=領著名
領著書=領著書
領著稱=領著稱
領著者=領著者
領著述=領著述
領著錄=領著錄
飄著=飄着
飄著作=飄著作
飄著名=飄著名
飄著書=飄著書
飄著稱=飄著稱
飄著者=飄著者
飄著述=飄著述
飄著錄=飄著錄
館裡=館裏
馆里=館裏
馬爾地夫=馬爾代夫
馬利共和國=馬里共和國
土豆=馬鈴薯
駕著=駕着
駕著作=駕著作
駕著名=駕著名
駕著書=駕著書
駕著稱=駕著稱
駕著者=駕著者
駕著述=駕著述
駕著錄=駕著錄
騎著=騎着
騎著作=騎著作
騎著名=騎著名
騎著書=騎著書
騎著稱=騎著稱
騎著者=騎著者
騎著述=騎著述
騎著錄=騎著錄
騙著=騙着
騙著作=騙著作
騙著名=騙著名
騙著書=騙著書
騙著稱=騙著稱
騙著者=騙著者
騙著述=騙著述
騙著錄=騙著錄
高著=高着
高著作=高著作
高著名=高著名
高著書=高著書
高著稱=高著稱
高著者=高著者
高著述=高著述
高著錄=高著錄
髭著=髭着
髭著作=髭著作
髭著名=髭著名
髭著書=髭著書
髭著稱=髭著稱
髭著者=髭著者
髭著述=髭著述
髭著錄=髭著錄
鬥著=鬥着
鬥著作=鬥著作
鬥著名=鬥著名
鬥著書=鬥著書
鬥著稱=鬥著稱
鬥著者=鬥著者
鬥著述=鬥著述
鬥著錄=鬥著錄
麗著=麗着
麗著作=麗著作
麗著名=麗著名
麗著書=麗著書
麗著稱=麗著稱
麗著者=麗著者
麗著述=麗著述
麗著錄=麗著錄
黏著=黏着
黏著作=黏著作
黏著名=黏著名
黏著書=黏著書
黏著稱=黏著稱
黏著者=黏著者
黏著述=黏著述
黏著錄=黏著錄
點著=點着
點著作=點著作
點著名=點著名
點著書=點著書
點著稱=點著稱
點著者=點著者
點著述=點著述
點著錄=點著錄
點裡=點裏
点里=點裏
);

$zh2CN = array(
16進位=16进位
16進位制=16进位制
『=‘
』=’
「=“
」=”
萬曆=万历
三極體=三极管
三極管=三极管
串列加速器=串列加速器
串列=串行
烏茲別克=乌兹别克斯坦
葉門=也门
芝士=乾酪
二極管=二极管
二極體=二极管
二進位制=二进位制
二進位=二进制
網際網路=互联网
互聯網=互联网
互動式=交互式
人工智慧=人工智能
甚麽=什么
甚麼=什么
乙太網=以太网
優先順序=优先级
感測=传感
伯利茲=伯利兹
貝里斯=伯利兹
點陣圖=位图
維德角=佛得角
常式=例程
侏儸紀=侏罗纪
海珊=侯赛因
攜帶型=便携式
資訊理論=信息论
母音=元音
游標=光标
光碟=光盘
光碟機=光驱
柯林頓=克林顿
克羅埃西亞=克罗地亚
進球=入球
全形=全角
八進位制=八进位制
八進位=八进制
六進位制=六进位制
六進位=六进制
記憶體=内存
甘比亞=冈比亚
防寫=写保护
軍中樂園=军中乐园
冷菜=凉菜
冷盤=凉菜
幾內亞比索=几内亚比绍
梵谷=凡高
計程車=出租车
解析度=分辨率
列支敦斯登=列支敦士登
賴比瑞亞=利比里亚
迦納=加纳
加彭=加蓬
載入=加载
十進位制=十进位制
十進位=十进制
半形=半角
华乐街=华乐街
波札那=博茨瓦纳
盧安達=卢旺达
衞生=卫生
衛生=卫生
瓜地馬拉=危地马拉
厄瓜多=厄瓜多尔
厄瓜多爾=厄瓜多尔
厄瓜多尔=厄瓜多尔
厄利垂亞=厄立特里亚
變數=变量
撞球=台球
桌球=台球
吉布地=吉布提
哈薩克=哈萨克斯坦
哥斯大黎加=哥斯达黎加
雜訊=噪声
因數=因子
吐瓦魯=图瓦卢
土庫曼=土库曼斯坦
聖露西亞=圣卢西亚
聖吉斯納域斯=圣基茨和尼维斯
聖克里斯多福及尼維斯=圣基茨和尼维斯
聖文森及格瑞那丁=圣文森特和格林纳丁斯
聖馬利諾=圣马力诺
蓋亞那=圭亚那
坦尚尼亞=坦桑尼亚
衣索比亞=埃塞俄比亚
衣索匹亞=埃塞俄比亚
功能變數名稱=域名
吉里巴斯=基里巴斯
塔吉克=塔吉克斯坦
塞拉利昂=塞拉利昂
塞普勒斯=塞浦路斯
塞席爾=塞舌尔
音效卡=声卡
多米尼克=多米尼加国
夜学=夜校
福士=大众
福斯=大众
大衛碧咸=大卫·贝克汉姆
頭槌=头球
賓士=奔驰
平治=奔驰
忌廉=奶油
字元会=字元会
字元會=字元会
字元濟=字元济
字元济=字元济
字型大小=字号
字型檔=字库
欄位=字段
字母=字母
字元=字符
字節=字节
位元組=字节
存檔=存盘
安地卡及巴布達=安提瓜和巴布达
巨集=宏
寬頻=宽带
定址=寻址
奈及利亞=尼日利亚
尼日利亞=尼日利亚
尼日利亚=尼日利亚
尼日爾=尼日尔
尼日尔=尼日尔
章節附註=尾注
區域網=局域网
巴貝多=巴巴多斯
巴布亞紐幾內亞=巴布亚新几内亚
布希=布什
布殊=布什
布基納法索=布基纳法索
布吉納法索=布基纳法索
布希亞=布希亚
布希亚=布希亚
蒲隆地=布隆迪
希特拉=希特勒
帛琉=帕劳
平治之乱=平治之乱
平治之亂=平治之乱
非同步=异步
迴圈=循环
快閃記憶體=快闪存储器
匯流排=总线
義大利=意大利
黛安娜=戴安娜
屋价=房价
索羅門群島=所罗门群岛
打印=打印
列印=打印
印表機=打印机
打印機=打印机
射門=打门
掃瞄器=扫瞄仪
括弧=括号
拿破崙=拿破仑
積架=捷豹
介面=接口
控制項=控件
資料庫=数据库
汶萊=文莱
史瓦濟蘭=斯威士兰
斯洛維尼亞=斯洛文尼亚
紐西蘭=新西兰
即食麵=方便面
快速面=方便面
泡麵=方便面
速食麵=方便面
伺服器=服务器
機械人=机器人
機器人=机器人
許可權=权限
寶獅=标志
格瑞那達=格林纳达
榴槤=榴莲
榴梿=榴莲
茅利塔尼亞=毛里塔尼亚
毛里裘斯=毛里求斯
模里西斯=毛里求斯
华乐=民乐
中樂=民乐
永曆=永历
沙地阿拉伯=沙特阿拉伯
沙烏地阿拉伯=沙特阿拉伯
波士尼亞赫塞哥維納=波斯尼亚和黑塞哥维那
辛巴威=津巴布韦
宏都拉斯=洪都拉斯
滑鼠蛇=滑鼠蛇
滿16進位=满16进位
滿二進位=满二进位
滿八進位=满八进位
滿六進位=满六进位
滿十六進位=满十六进位
滿十進位=满十进位
蓋火鍋=火锅盖帽
千里達托貝哥=特立尼达和托巴哥
狗隻=犬只
卡佩雅蒂=珍妮弗·卡普里亚蒂
諾魯=瑙鲁
萬那杜=瓦努阿图
溫納圖=瓦努阿图
碟片=盘片
短訊=短信
簡訊=短信
矽尘=矽尘
矽塵=矽尘
矽肺=矽肺
矽钢=矽钢
矽鋼=矽钢
矽=硅
矽片=硅片
矽谷=硅谷
硬體=硬件
硬碟=硬盘
磁碟=磁盘
磁軌=磁道
葛摩=科摩罗
象牙海岸=科特迪瓦
行動電話=移动电话
流動電話=移动电话
程式控制=程控
突尼西亞=突尼斯
谐星=笑星
等於=等于
運算元=算子
演算法=算法
顆進球=粒入球
索馬利亞=索马里
網路=网络
網絡=网络
寮國=老挝
肯雅=肯尼亚
肯亞=肯尼亚
單車=自行车
太空梭=航天飞机
穿梭機=航天飞机
節慶=节日
晶元=芯片
晶片=芯片
蘇利南=苏里南
士多啤梨=草莓
莫三比克=莫桑比克
賴索托=莱索托
辭彙=词汇
片語=词组
調制解調器=调制解调器
數據機=调制解调器
貝南=贝宁
尚比亞=赞比亚
绑紧跳=蹦极跳
笨豬跳=蹦极跳
軟體=软件
軟件=软件
軟碟機=软驱
米高奧雲=迈克尔·欧文
舒麥加=迈克尔·舒马赫
遠程控制=远程控制
远程控制=远程控制
亞塞拜然=阿塞拜疆
阿拉伯聯合大公國=阿拉伯联合酋长国
散钱=零钱
南韓=韩国
馬爾地夫=马尔代夫
沙芬=马拉特·萨芬
馬爾他=马耳他
萬事得=马自达
馬利共和國=马里共和国
預設=默认
滑鼠=鼠标